﻿Codi Província;Nom Província;Codi Vegueria;Nom Vegueria;Codi Comarca;Nom Comarca;Codi Municipi;Nom Municipi;Districte;Població;Cens;Participació 13:00;Participació 18:00;Participació 20:00;Abstenció;Vots nuls;Vots en blanc;Vots a candidatures;Vots vàlids
25;Lleida;5;Alt Pirineu i territori d'Aran;25;Pallars Jussà;25001;Abella de la Conca;1;;134;25;48;62;72;0;2;60;62
8;Barcelona;1;Barcelona;11;Baix Llobregat;08001;Abrera;1;;9262;2309;4263;4966;4296;66;42;4858;4900
25;Lleida;4;Lleida;23;Noguera;25002;Àger;1;;457;131;223;301;156;6;4;291;295
25;Lleida;4;Lleida;38;Urgell;25003;Agramunt;1;;3733;926;1743;2053;1680;37;38;1978;2016
8;Barcelona;2;Catalunya Central;7;Bages;08002;Aguilar de Segarra;1;;218;77;145;170;48;1;1;168;169
17;Girona;3;Girona;2;Alt Empordà;17001;Agullana;1;;596;201;351;393;203;14;5;374;379
8;Barcelona;1;Barcelona;41;Vallès Oriental;08014;Aiguafreda;1;;2048;456;975;1230;818;15;15;1200;1215
43;Tarragona;6;Camp de Tarragona;1;Alt Camp;43001;Aiguamúrcia;1;;739;193;381;404;335;7;5;392;397
17;Girona;3;Girona;20;Gironès;17002;Aiguaviva;1;;600;188;393;446;154;6;0;440;440
25;Lleida;4;Lleida;33;Segrià;25038;Aitona;1;;1416;426;741;902;514;17;15;870;885
25;Lleida;4;Lleida;33;Segrià;25004;Alamús, els;1;;566;189;319;364;202;11;5;348;353
25;Lleida;5;Alt Pirineu i territori d'Aran;4;Alt Urgell;25005;Alàs i Cerc;1;;262;72;153;167;95;0;4;163;167
25;Lleida;4;Lleida;18;Garrigues;25006;Albagés, l';1;;315;126;172;201;114;9;3;189;192
17;Girona;3;Girona;2;Alt Empordà;17003;Albanyà;1;;112;33;70;77;35;0;0;77;77
25;Lleida;4;Lleida;33;Segrià;25007;Albatàrrec;1;;1399;214;662;742;657;22;9;711;720
25;Lleida;4;Lleida;23;Noguera;25008;Albesa;1;;1089;274;551;625;464;6;10;609;619
25;Lleida;4;Lleida;18;Garrigues;25009;Albi, l';1;;594;180;361;413;181;4;8;401;409
43;Tarragona;8;Penedès;12;Baix Penedès;43002;Albinyana;1;;1933;447;761;849;1084;22;2;825;827
43;Tarragona;6;Camp de Tarragona;8;Baix Camp;43003;Albiol, l';1;;357;99;167;190;167;2;5;183;188
17;Girona;3;Girona;10;Baix Empordà;17004;Albons;1;;558;204;325;376;182;5;2;369;371
43;Tarragona;7;Terres de l'Ebre;22;Montsià;43004;Alcanar;1;;4999;1071;2016;2401;2598;49;21;2331;2352
43;Tarragona;7;Terres de l'Ebre;22;Montsià;43004;Alcanar;2;;1382;276;465;540;842;9;5;526;531
25;Lleida;4;Lleida;33;Segrià;25010;Alcanó;1;;194;59;109;131;63;2;0;129;129
25;Lleida;4;Lleida;33;Segrià;25011;Alcarràs;1;;5289;1181;2182;2512;2777;51;38;2423;2461
25;Lleida;4;Lleida;33;Segrià;25012;Alcoletge;1;;2383;585;1047;1192;1191;33;18;1141;1159
43;Tarragona;6;Camp de Tarragona;1;Alt Camp;43005;Alcover;1;;1889;383;814;987;902;17;8;962;970
43;Tarragona;6;Camp de Tarragona;1;Alt Camp;43005;Alcover;2;;1792;394;712;838;954;13;12;813;825
43;Tarragona;7;Terres de l'Ebre;9;Baix Ebre;43904;Aldea, l';1;;2851;688;963;1188;1663;42;14;1132;1146
43;Tarragona;7;Terres de l'Ebre;9;Baix Ebre;43006;Aldover;1;;686;168;291;358;328;10;2;346;348
43;Tarragona;6;Camp de Tarragona;8;Baix Camp;43007;Aleixar, l';1;;665;179;365;412;253;2;3;407;410
8;Barcelona;1;Barcelona;21;Maresme;08003;Alella;1;;7246;1892;3696;4531;2715;43;35;4453;4488
43;Tarragona;7;Terres de l'Ebre;9;Baix Ebre;43008;Alfara de Carles;1;;314;64;100;121;193;3;1;117;118
25;Lleida;4;Lleida;33;Segrià;25013;Alfarràs;1;;2072;518;916;1071;1001;10;15;1046;1061
25;Lleida;4;Lleida;33;Segrià;25014;Alfés;1;;250;88;151;168;82;4;0;164;164
43;Tarragona;6;Camp de Tarragona;8;Baix Camp;43009;Alforja;1;;1417;383;688;800;617;12;7;781;788
25;Lleida;4;Lleida;23;Noguera;25015;Algerri;1;;347;119;192;212;135;3;0;209;209
25;Lleida;4;Lleida;33;Segrià;25016;Alguaire;1;;2074;570;960;1125;949;18;13;1094;1107
25;Lleida;5;Alt Pirineu i territori d'Aran;26;Pallars Sobirà;25017;Alins;1;;231;42;113;157;74;4;2;151;153
43;Tarragona;6;Camp de Tarragona;1;Alt Camp;43010;Alió;1;;349;111;179;202;147;1;2;199;201
25;Lleida;4;Lleida;33;Segrià;25019;Almacelles;1;;2178;409;856;1012;1166;31;8;973;981
25;Lleida;4;Lleida;33;Segrià;25019;Almacelles;2;;2413;506;910;1081;1332;30;9;1042;1051
25;Lleida;4;Lleida;33;Segrià;25020;Almatret;1;;272;99;178;199;73;2;4;193;197
25;Lleida;4;Lleida;33;Segrià;25021;Almenar;1;;589;111;203;257;332;5;3;249;252
25;Lleida;4;Lleida;33;Segrià;25021;Almenar;2;;1938;424;798;1010;928;11;6;993;999
43;Tarragona;6;Camp de Tarragona;8;Baix Camp;43011;Almoster;1;;1094;338;638;739;355;10;6;723;729
25;Lleida;4;Lleida;23;Noguera;25022;Alòs de Balaguer;1;;103;30;48;62;41;0;0;62;62
17;Girona;5;Alt Pirineu i territori d'Aran;15;Cerdanya;17006;Alp;1;;1228;274;523;735;493;24;4;707;711
8;Barcelona;2;Catalunya Central;24;Osona;08004;Alpens;1;;212;88;150;178;34;2;3;173;176
25;Lleida;4;Lleida;33;Segrià;25023;Alpicat;1;;4642;952;2036;2699;1943;45;29;2625;2654
43;Tarragona;6;Camp de Tarragona;36;Tarragonès;43012;Altafulla;1;;3810;1109;2072;2478;1332;40;30;2408;2438
25;Lleida;5;Alt Pirineu i territori d'Aran;26;Pallars Sobirà;25024;Alt Àneu;1;;366;88;166;248;118;1;1;246;247
17;Girona;3;Girona;34;Selva;17007;Amer;1;;1788;598;1016;1128;660;26;5;1097;1102
8;Barcelona;1;Barcelona;41;Vallès Oriental;08005;Ametlla del Vallès, l';1;;6576;1097;3006;3912;2664;71;29;3812;3841
43;Tarragona;7;Terres de l'Ebre;9;Baix Ebre;43013;Ametlla de Mar, l';1;;4532;1195;1912;2406;2126;61;25;2320;2345
43;Tarragona;7;Terres de l'Ebre;9;Baix Ebre;43906;Ampolla, l';1;;2181;656;1015;1236;945;46;4;1186;1190
43;Tarragona;7;Terres de l'Ebre;22;Montsià;43014;Amposta;1;;1490;457;646;721;769;17;5;699;704
43;Tarragona;7;Terres de l'Ebre;22;Montsià;43014;Amposta;2;;1343;350;553;628;715;18;10;600;610
43;Tarragona;7;Terres de l'Ebre;22;Montsià;43014;Amposta;3;;2217;513;835;980;1237;35;6;939;945
43;Tarragona;7;Terres de l'Ebre;22;Montsià;43014;Amposta;4;;9417;2161;3730;4334;5083;138;53;4143;4196
17;Girona;3;Girona;34;Selva;17008;Anglès;1;;3561;996;1744;1997;1564;28;13;1956;1969
25;Lleida;4;Lleida;38;Urgell;25027;Anglesola;1;;971;319;513;569;402;6;6;557;563
25;Lleida;4;Lleida;18;Garrigues;25029;Arbeca;1;;1581;401;785;971;610;17;5;949;954
43;Tarragona;8;Penedès;12;Baix Penedès;43016;Arboç, l';1;;3457;906;1661;1871;1586;52;13;1806;1819
43;Tarragona;6;Camp de Tarragona;8;Baix Camp;43015;Arbolí;1;;111;53;77;90;21;3;1;86;87
17;Girona;3;Girona;34;Selva;17009;Arbúcies;1;;3099;784;1499;1818;1281;24;17;1777;1794
17;Girona;3;Girona;34;Selva;17009;Arbúcies;2;;1010;257;516;624;386;7;5;612;617
8;Barcelona;1;Barcelona;21;Maresme;08006;Arenys de Mar;1;;5465;1249;2529;3033;2432;51;22;2960;2982
8;Barcelona;1;Barcelona;21;Maresme;08006;Arenys de Mar;2;;6356;1372;2511;3393;2963;38;26;3329;3355
8;Barcelona;1;Barcelona;21;Maresme;08007;Arenys de Munt;1;;3576;748;1753;2023;1553;24;17;1982;1999
8;Barcelona;1;Barcelona;21;Maresme;08007;Arenys de Munt;2;;3355;695;1601;1902;1453;28;19;1855;1874
17;Girona;3;Girona;19;Garrotxa;17010;Argelaguer;1;;330;99;179;210;120;2;4;204;208
8;Barcelona;8;Penedès;6;Anoia;08008;Argençola;1;;177;64;108;117;60;1;3;113;116
43;Tarragona;6;Camp de Tarragona;8;Baix Camp;43017;Argentera, l';1;;116;69;91;98;18;1;0;97;97
8;Barcelona;1;Barcelona;21;Maresme;08009;Argentona;1;;6600;1649;3320;3845;2755;34;25;3786;3811
8;Barcelona;1;Barcelona;21;Maresme;08009;Argentona;2;;3052;737;1392;1629;1423;28;20;1581;1601
17;Girona;3;Girona;2;Alt Empordà;17011;Armentera, l';1;;654;244;432;481;173;1;11;469;480
43;Tarragona;7;Terres de l'Ebre;37;Terra Alta;43018;Arnes;1;;376;173;254;306;70;15;7;284;291
25;Lleida;5;Alt Pirineu i territori d'Aran;39;Consell General d'Aran;25031;Arres;1;;55;8;11;29;26;0;2;27;29
25;Lleida;5;Alt Pirineu i territori d'Aran;4;Alt Urgell;25032;Arsèguel;1;;65;15;33;44;21;1;1;42;43
8;Barcelona;2;Catalunya Central;7;Bages;08010;Artés;1;;1060;203;495;570;490;3;2;565;567
8;Barcelona;2;Catalunya Central;7;Bages;08010;Artés;2;;3190;723;1615;1908;1282;32;16;1860;1876
25;Lleida;4;Lleida;33;Segrià;25033;Artesa de Lleida;1;;1129;342;629;751;378;8;8;735;743
25;Lleida;4;Lleida;23;Noguera;25034;Artesa de Segre;1;;2272;484;1115;1332;940;22;11;1299;1310
43;Tarragona;7;Terres de l'Ebre;30;Ribera d'Ebre;43019;Ascó;1;;1297;326;558;702;595;14;7;681;688
25;Lleida;4;Lleida;33;Segrià;25036;Aspa;1;;172;68;108;122;50;1;2;119;121
25;Lleida;4;Lleida;23;Noguera;25037;Avellanes i Santa Linya, les;1;;368;93;171;201;167;4;5;192;197
8;Barcelona;2;Catalunya Central;14;Berguedà;08011;Avià;1;;1745;472;978;1118;627;18;9;1091;1100
8;Barcelona;2;Catalunya Central;7;Bages;08012;Avinyó;1;;1728;506;945;1078;650;12;13;1053;1066
8;Barcelona;8;Penedès;3;Alt Penedès;08013;Avinyonet del Penedès;1;;1297;379;714;815;482;12;7;796;803
17;Girona;3;Girona;2;Alt Empordà;17012;Avinyonet de Puigventós;1;;1211;291;622;687;524;13;2;672;674
8;Barcelona;1;Barcelona;13;Barcelonès;08015;Badalona;1;;6220;1834;3702;4081;2139;54;23;4004;4027
8;Barcelona;1;Barcelona;13;Barcelonès;08015;Badalona;2;;13602;2773;5590;6652;6950;81;56;6515;6571
8;Barcelona;1;Barcelona;13;Barcelonès;08015;Badalona;3;;13511;3271;6594;7595;5916;90;55;7450;7505
8;Barcelona;1;Barcelona;13;Barcelonès;08015;Badalona;4;;20624;3947;8648;10116;10508;150;82;9884;9966
8;Barcelona;1;Barcelona;13;Barcelonès;08015;Badalona;5;;9419;2395;4917;5672;3747;66;41;5565;5606
8;Barcelona;1;Barcelona;13;Barcelonès;08015;Badalona;6;;6113;1176;2222;2518;3595;49;7;2462;2469
8;Barcelona;1;Barcelona;13;Barcelonès;08015;Badalona;7;;27640;5143;10552;11869;15771;145;89;11635;11724
8;Barcelona;1;Barcelona;13;Barcelonès;08015;Badalona;8;;14267;2414;5441;6286;7981;109;30;6147;6177
8;Barcelona;1;Barcelona;13;Barcelonès;08015;Badalona;9;;43955;8207;14492;16297;27658;207;139;15951;16090
8;Barcelona;1;Barcelona;40;Vallès Occidental;08904;Badia del Vallès;1;;10396;2116;3684;4253;6143;51;31;4171;4202
8;Barcelona;2;Catalunya Central;14;Berguedà;08016;Bagà;1;;1789;572;900;1125;664;13;11;1101;1112
25;Lleida;5;Alt Pirineu i territori d'Aran;26;Pallars Sobirà;25039;Baix Pallars;1;;279;65;129;195;84;2;2;191;193
25;Lleida;4;Lleida;23;Noguera;25040;Balaguer;1;;1629;385;693;786;843;19;5;762;767
25;Lleida;4;Lleida;23;Noguera;25040;Balaguer;2;;871;159;265;299;572;2;15;282;297
25;Lleida;4;Lleida;23;Noguera;25040;Balaguer;3;;2889;572;1123;1324;1565;31;13;1280;1293
25;Lleida;4;Lleida;23;Noguera;25040;Balaguer;4;;5297;1197;2451;2940;2357;65;24;2851;2875
8;Barcelona;2;Catalunya Central;24;Osona;08017;Balenyà;1;;2824;578;1269;1533;1291;13;26;1494;1520
8;Barcelona;2;Catalunya Central;7;Bages;08018;Balsareny;1;;2564;615;1117;1385;1179;17;10;1358;1368
43;Tarragona;8;Penedès;12;Baix Penedès;43020;Banyeres del Penedès;1;;2347;568;1041;1199;1148;19;8;1172;1180
17;Girona;3;Girona;28;Pla de l'Estany;17015;Banyoles;1;;5254;1376;2731;3111;2143;61;19;3031;3050
17;Girona;3;Girona;28;Pla de l'Estany;17015;Banyoles;2;;5149;1414;2958;3433;1716;43;27;3363;3390
17;Girona;3;Girona;28;Pla de l'Estany;17015;Banyoles;3;;2534;599;1288;1440;1094;15;18;1407;1425
25;Lleida;4;Lleida;27;Pla d'Urgell;25041;Barbens;1;;523;154;242;283;240;4;10;269;279
43;Tarragona;6;Camp de Tarragona;16;Conca de Barberà;43021;Barberà de la Conca;1;;334;114;178;208;126;6;3;199;202
8;Barcelona;1;Barcelona;40;Vallès Occidental;08252;Barberà del Vallès;1;;24879;4993;10799;12693;12186;203;91;12399;12490
8;Barcelona;1;Barcelona;13;Barcelonès;08019;Barcelona;1;;44821;8120;16619;19836;24985;235;124;19477;19601
8;Barcelona;1;Barcelona;13;Barcelonès;08019;Barcelona;10;;161032;35788;74810;91256;69776;997;676;89583;90259
8;Barcelona;1;Barcelona;13;Barcelonès;08019;Barcelona;2;;175436;38512;86704;108056;67380;1067;717;106272;106989
8;Barcelona;1;Barcelona;13;Barcelonès;08019;Barcelona;3;;122174;25869;54582;65389;56785;701;386;64302;64688
8;Barcelona;1;Barcelona;13;Barcelonès;08019;Barcelona;4;;59466;16209;32006;38880;20586;406;233;38241;38474
8;Barcelona;1;Barcelona;13;Barcelonès;08019;Barcelona;5;;104221;26053;57113;71322;32899;663;532;70127;70659
8;Barcelona;1;Barcelona;13;Barcelonès;08019;Barcelona;6;;83867;20791;43616;53124;30743;518;366;52240;52606
8;Barcelona;1;Barcelona;13;Barcelonès;08019;Barcelona;7;;123541;27798;56017;66034;57507;793;419;64822;65241
8;Barcelona;1;Barcelona;13;Barcelonès;08019;Barcelona;8;;116657;24327;46864;53707;62950;682;356;52669;53025
8;Barcelona;1;Barcelona;13;Barcelonès;08019;Barcelona;9;;108068;24449;51274;60398;47670;742;376;59280;59656
25;Lleida;4;Lleida;23;Noguera;25042;Baronia de Rialb, la;1;;202;81;128;140;62;1;1;138;139
17;Girona;3;Girona;2;Alt Empordà;17016;Bàscara;1;;739;200;433;474;265;11;6;457;463
25;Lleida;5;Alt Pirineu i territori d'Aran;4;Alt Urgell;25044;Bassella;1;;180;65;101;130;50;3;1;126;127
43;Tarragona;7;Terres de l'Ebre;37;Terra Alta;43022;Batea;1;;1430;395;672;895;535;15;10;870;880
25;Lleida;5;Alt Pirineu i territori d'Aran;39;Consell General d'Aran;25045;Bausen;1;;59;6;10;25;34;1;1;23;24
8;Barcelona;1;Barcelona;11;Baix Llobregat;08020;Begues;1;;5374;1108;2614;3400;1974;24;34;3342;3376
17;Girona;3;Girona;10;Baix Empordà;17013;Begur;1;;2832;796;1408;1612;1220;26;17;1569;1586
25;Lleida;4;Lleida;38;Urgell;25046;Belianes;1;;408;134;228;271;137;10;4;257;261
25;Lleida;4;Lleida;18;Garrigues;25170;Bellaguarda;1;;257;76;149;186;71;0;1;185;186
17;Girona;3;Girona;10;Baix Empordà;17018;Bellcaire d'Empordà;1;;501;188;313;345;156;7;2;336;338
25;Lleida;4;Lleida;23;Noguera;25047;Bellcaire d'Urgell;1;;946;357;573;665;281;6;10;649;659
25;Lleida;4;Lleida;27;Pla d'Urgell;25048;Bell-lloc d'Urgell;1;;1639;387;853;1006;633;30;12;964;976
25;Lleida;4;Lleida;23;Noguera;25049;Bellmunt d'Urgell;1;;150;58;94;107;43;8;0;99;99
43;Tarragona;6;Camp de Tarragona;29;Priorat;43023;Bellmunt del Priorat;1;;209;82;123;151;58;4;5;142;147
8;Barcelona;8;Penedès;6;Anoia;08021;Bellprat;1;;64;29;35;41;23;2;0;39;39
25;Lleida;4;Lleida;38;Urgell;25050;Bellpuig;1;;3269;843;1499;1846;1423;21;17;1808;1825
43;Tarragona;8;Penedès;12;Baix Penedès;43024;Bellvei;1;;1616;368;663;754;862;12;9;733;742
25;Lleida;5;Alt Pirineu i territori d'Aran;15;Cerdanya;25051;Bellver de Cerdanya;1;;1619;376;689;995;624;29;10;956;966
25;Lleida;4;Lleida;27;Pla d'Urgell;25052;Bellvís;1;;1555;416;876;976;579;20;10;946;956
25;Lleida;4;Lleida;33;Segrià;25053;Benavent de Segrià;1;;1111;258;566;679;432;5;4;670;674
43;Tarragona;7;Terres de l'Ebre;9;Baix Ebre;43025;Benifallet;1;;577;196;320;376;201;6;2;368;370
43;Tarragona;7;Terres de l'Ebre;30;Ribera d'Ebre;43026;Benissanet;1;;764;247;438;502;262;8;7;487;494
8;Barcelona;2;Catalunya Central;14;Berguedà;08022;Berga;1;;6440;1697;3075;3539;2901;48;41;3450;3491
8;Barcelona;2;Catalunya Central;14;Berguedà;08022;Berga;2;;4671;917;2002;2277;2394;38;19;2220;2239
8;Barcelona;2;Catalunya Central;14;Berguedà;08022;Berga;3;;458;170;256;280;178;1;1;278;279
8;Barcelona;2;Catalunya Central;14;Berguedà;08022;Berga;4;;607;191;324;368;239;6;3;359;362
17;Girona;3;Girona;19;Garrotxa;17019;Besalú;1;;1801;553;1059;1174;627;24;18;1132;1150
17;Girona;3;Girona;20;Gironès;17020;Bescanó;1;;3768;885;2060;2375;1393;23;24;2328;2352
17;Girona;3;Girona;19;Garrotxa;17021;Beuda;1;;121;40;72;79;42;3;1;75;76
8;Barcelona;1;Barcelona;41;Vallès Oriental;08023;Bigues i Riells;1;;7257;1571;3039;3656;3601;63;26;3567;3593
25;Lleida;4;Lleida;32;Segarra;25055;Biosca;1;;161;56;78;94;67;2;1;91;92
17;Girona;3;Girona;10;Baix Empordà;17022;Bisbal d'Empordà, la;1;;4066;1034;2072;2302;1764;30;23;2249;2272
17;Girona;3;Girona;10;Baix Empordà;17022;Bisbal d'Empordà, la;2;;3066;638;1463;1646;1420;33;21;1592;1613
43;Tarragona;6;Camp de Tarragona;29;Priorat;43027;Bisbal de Falset, la;1;;169;56;116;128;41;0;0;128;128
43;Tarragona;8;Penedès;12;Baix Penedès;43028;Bisbal del Penedès, la;1;;2906;448;1000;1177;1729;26;5;1146;1151
17;Girona;3;Girona;2;Alt Empordà;17234;Biure;1;;183;74;104;116;67;1;2;113;115
43;Tarragona;6;Camp de Tarragona;16;Conca de Barberà;43029;Blancafort;1;;311;110;183;219;92;6;4;209;213
17;Girona;3;Girona;34;Selva;17023;Blanes;1;;6130;1459;2855;3251;2879;53;23;3175;3198
17;Girona;3;Girona;34;Selva;17023;Blanes;2;;16642;3048;6627;7843;8799;151;76;7616;7692
17;Girona;3;Girona;34;Selva;17023;Blanes;3;;5000;1127;1991;2219;2781;53;30;2136;2166
17;Girona;3;Girona;2;Alt Empordà;17029;Boadella i les Escaules;1;;214;98;127;137;77;0;2;135;137
17;Girona;5;Alt Pirineu i territori d'Aran;15;Cerdanya;17024;Bolvir;1;;335;78;158;237;98;13;2;222;224
43;Tarragona;8;Penedès;12;Baix Penedès;43030;Bonastre;1;;505;155;269;298;207;3;4;291;295
25;Lleida;5;Alt Pirineu i territori d'Aran;39;Consell General d'Aran;25057;Bòrdes, es;1;;222;41;70;109;113;6;2;101;103
17;Girona;3;Girona;20;Gironès;17025;Bordils;1;;1197;432;752;841;356;12;4;825;829
25;Lleida;4;Lleida;18;Garrigues;25058;Borges Blanques, les;1;;1778;405;816;1010;768;21;7;982;989
25;Lleida;4;Lleida;18;Garrigues;25058;Borges Blanques, les;2;;2597;572;1168;1422;1175;14;20;1388;1408
43;Tarragona;6;Camp de Tarragona;8;Baix Camp;43031;Borges del Camp, les;1;;1464;439;793;904;560;16;1;887;888
17;Girona;3;Girona;2;Alt Empordà;17026;Borrassà;1;;547;174;350;380;167;2;8;370;378
8;Barcelona;2;Catalunya Central;14;Berguedà;08024;Borredà;1;;363;121;203;232;131;2;4;226;230
25;Lleida;5;Alt Pirineu i territori d'Aran;39;Consell General d'Aran;25059;Bossòst;1;;822;202;364;464;358;22;5;437;442
43;Tarragona;7;Terres de l'Ebre;37;Terra Alta;43032;Bot;1;;454;159;270;324;130;4;1;319;320
43;Tarragona;6;Camp de Tarragona;8;Baix Camp;43033;Botarell;1;;793;212;408;487;306;5;3;479;482
25;Lleida;4;Lleida;18;Garrigues;25056;Bovera;1;;207;64;107;120;87;4;7;109;116
43;Tarragona;6;Camp de Tarragona;1;Alt Camp;43034;Bràfim;1;;477;147;264;303;174;5;4;294;298
17;Girona;3;Girona;34;Selva;17027;Breda;1;;2918;765;1500;1735;1183;35;14;1686;1700
8;Barcelona;8;Penedès;6;Anoia;08025;Bruc, el;1;;1615;300;746;884;731;13;13;858;871
8;Barcelona;2;Catalunya Central;24;Osona;08026;Brull, el;1;;201;72;136;152;49;0;2;150;152
17;Girona;3;Girona;34;Selva;17028;Brunyola i Sant Martí Sapresa;1;;293;97;163;185;108;5;1;179;180
43;Tarragona;6;Camp de Tarragona;29;Priorat;43035;Cabacés;1;;238;66;131;164;74;9;4;151;155
25;Lleida;4;Lleida;23;Noguera;25060;Cabanabona;1;;65;11;29;37;28;1;2;34;36
17;Girona;3;Girona;2;Alt Empordà;17031;Cabanelles;1;;166;38;67;77;89;0;2;75;77
17;Girona;3;Girona;2;Alt Empordà;17030;Cabanes;1;;640;187;338;363;277;4;3;356;359
8;Barcelona;8;Penedès;3;Alt Penedès;08027;Cabanyes, les;1;;745;249;461;497;248;8;2;487;489
25;Lleida;5;Alt Pirineu i territori d'Aran;4;Alt Urgell;25061;Cabó;1;;79;20;35;47;32;1;1;45;46
43;Tarragona;6;Camp de Tarragona;1;Alt Camp;43036;Cabra del Camp;1;;901;186;335;380;521;5;4;371;375
8;Barcelona;8;Penedès;6;Anoia;08028;Cabrera d'Anoia;1;;1153;283;471;522;631;6;6;510;516
8;Barcelona;1;Barcelona;21;Maresme;08029;Cabrera de Mar;1;;3673;922;1959;2447;1226;40;25;2382;2407
8;Barcelona;1;Barcelona;21;Maresme;08030;Cabrils;1;;5295;1057;2668;3360;1935;23;29;3308;3337
17;Girona;3;Girona;2;Alt Empordà;17032;Cadaqués;1;;1793;380;777;931;862;14;15;902;917
8;Barcelona;2;Catalunya Central;6;Anoia;08031;Calaf;1;;2313;547;1186;1360;953;32;16;1312;1328
43;Tarragona;8;Penedès;12;Baix Penedès;43037;Calafell;1;;5508;1201;2318;2673;2835;50;23;2600;2623
43;Tarragona;8;Penedès;12;Baix Penedès;43037;Calafell;2;;4367;1026;1818;2153;2214;43;18;2092;2110
43;Tarragona;8;Penedès;12;Baix Penedès;43037;Calafell;3;;8119;1561;2799;3258;4861;76;30;3152;3182
43;Tarragona;8;Penedès;12;Baix Penedès;43037;Calafell;4;;883;123;253;293;590;11;1;281;282
8;Barcelona;2;Catalunya Central;42;Moianès;08034;Calders;1;;837;249;513;557;280;7;4;546;550
8;Barcelona;1;Barcelona;21;Maresme;08032;Caldes d'Estrac;1;;2169;403;982;1276;893;19;9;1248;1257
17;Girona;3;Girona;34;Selva;17033;Caldes de Malavella;1;;5831;1219;2350;2826;3005;31;34;2761;2795
8;Barcelona;1;Barcelona;41;Vallès Oriental;08033;Caldes de Montbui;1;;3952;893;1847;2151;1801;35;17;2099;2116
8;Barcelona;1;Barcelona;41;Vallès Oriental;08033;Caldes de Montbui;2;;1697;498;895;1033;664;15;6;1012;1018
8;Barcelona;1;Barcelona;41;Vallès Oriental;08033;Caldes de Montbui;3;;7723;1607;3607;4249;3474;46;42;4161;4203
8;Barcelona;1;Barcelona;21;Maresme;08035;Calella;1;;3758;731;1675;1911;1847;18;27;1866;1893
8;Barcelona;1;Barcelona;21;Maresme;08035;Calella;2;;2421;520;1081;1316;1105;24;12;1280;1292
8;Barcelona;1;Barcelona;21;Maresme;08035;Calella;3;;6893;1373;3154;3746;3147;57;33;3656;3689
8;Barcelona;2;Catalunya Central;24;Osona;08037;Calldetenes;1;;1948;545;1112;1295;653;15;12;1268;1280
8;Barcelona;2;Catalunya Central;7;Bages;08038;Callús;1;;1535;451;813;927;608;12;13;902;915
17;Girona;3;Girona;10;Baix Empordà;17034;Calonge i Sant Antoni;1;;7395;1769;3186;3797;3598;45;33;3719;3752
8;Barcelona;2;Catalunya Central;6;Anoia;08036;Calonge de Segarra;1;;159;60;106;120;39;3;0;117;117
25;Lleida;4;Lleida;23;Noguera;25062;Camarasa;1;;691;233;385;430;261;6;3;421;424
43;Tarragona;7;Terres de l'Ebre;9;Baix Ebre;43903;Camarles;1;;2327;573;894;1037;1290;48;5;984;989
43;Tarragona;6;Camp de Tarragona;8;Baix Camp;43038;Cambrils;1;;8606;1881;3535;4074;4532;75;27;3972;3999
43;Tarragona;6;Camp de Tarragona;8;Baix Camp;43038;Cambrils;2;;13908;3207;6139;7189;6719;106;55;7028;7083
17;Girona;3;Girona;28;Pla de l'Estany;17035;Camós;1;;547;201;354;403;144;8;2;393;395
17;Girona;3;Girona;31;Ripollès;17036;Campdevànol;1;;2634;620;1210;1487;1147;41;13;1433;1446
17;Girona;3;Girona;31;Ripollès;17037;Campelles;1;;114;39;55;74;40;1;1;72;73
8;Barcelona;1;Barcelona;41;Vallès Oriental;08039;Campins;1;;413;142;256;290;123;5;5;280;285
17;Girona;3;Girona;20;Gironès;17038;Campllong;1;;380;127;245;281;99;12;1;268;269
17;Girona;3;Girona;31;Ripollès;17039;Camprodon;1;;1780;458;897;1113;667;74;13;1026;1039
25;Lleida;5;Alt Pirineu i territori d'Aran;39;Consell General d'Aran;25063;Canejan;1;;76;21;22;32;44;0;0;32;32
17;Girona;3;Girona;20;Gironès;17040;Canet d'Adri;1;;567;200;333;371;196;3;3;365;368
8;Barcelona;1;Barcelona;21;Maresme;08040;Canet de Mar;1;;11167;2831;5129;5901;5266;75;40;5786;5826
43;Tarragona;6;Camp de Tarragona;36;Tarragonès;43907;Canonja, la;1;;4425;980;1747;2082;2343;45;16;2021;2037
8;Barcelona;1;Barcelona;41;Vallès Oriental;08041;Canovelles;1;;10725;2397;4331;4837;5888;70;34;4733;4767
8;Barcelona;1;Barcelona;41;Vallès Oriental;08042;Cànoves i Samalús;1;;2465;566;1157;1293;1172;10;11;1272;1283
17;Girona;3;Girona;2;Alt Empordà;17041;Cantallops;1;;213;61;115;130;83;9;1;120;121
8;Barcelona;8;Penedès;17;Garraf;08043;Canyelles;1;;3553;818;1474;1706;1847;20;21;1665;1686
43;Tarragona;6;Camp de Tarragona;8;Baix Camp;43039;Capafonts;1;;103;44;60;70;33;0;0;70;70
43;Tarragona;6;Camp de Tarragona;29;Priorat;43040;Capçanes;1;;326;138;222;250;76;2;4;244;248
8;Barcelona;8;Penedès;6;Anoia;08044;Capellades;1;;1799;341;671;802;997;14;6;782;788
8;Barcelona;8;Penedès;6;Anoia;08044;Capellades;2;;2318;578;1153;1314;1004;21;13;1280;1293
17;Girona;3;Girona;2;Alt Empordà;17042;Capmany;1;;422;133;238;265;157;1;5;259;264
8;Barcelona;2;Catalunya Central;14;Berguedà;08045;Capolat;1;;63;22;30;41;22;0;0;41;41
8;Barcelona;1;Barcelona;41;Vallès Oriental;08046;Cardedeu;1;;3844;826;1982;2345;1499;32;18;2295;2313
8;Barcelona;1;Barcelona;41;Vallès Oriental;08046;Cardedeu;2;;7153;1631;3640;4279;2874;68;24;4187;4211
8;Barcelona;1;Barcelona;41;Vallès Oriental;08046;Cardedeu;3;;2752;444;1204;1428;1324;24;17;1387;1404
8;Barcelona;2;Catalunya Central;7;Bages;08047;Cardona;1;;2780;678;1204;1468;1312;32;14;1422;1436
8;Barcelona;2;Catalunya Central;7;Bages;08047;Cardona;2;;888;212;378;444;444;8;4;432;436
8;Barcelona;8;Penedès;6;Anoia;08048;Carme;1;;574;188;339;376;198;5;5;366;371
43;Tarragona;7;Terres de l'Ebre;37;Terra Alta;43041;Caseres;1;;204;42;87;110;94;4;1;105;106
17;Girona;3;Girona;20;Gironès;17044;Cassà de la Selva;1;;2814;635;1488;1739;1075;29;9;1701;1710
17;Girona;3;Girona;20;Gironès;17044;Cassà de la Selva;2;;4227;933;2072;2406;1821;51;13;2342;2355
8;Barcelona;2;Catalunya Central;14;Berguedà;08049;Casserres;1;;1308;386;684;773;535;11;6;756;762
25;Lleida;2;Catalunya Central;35;Solsonès;25064;Castellar de la Ribera;1;;94;34;62;74;20;1;1;72;73
8;Barcelona;2;Catalunya Central;14;Berguedà;08050;Castellar del Riu;1;;130;55;86;98;32;2;0;96;96
8;Barcelona;1;Barcelona;40;Vallès Occidental;08051;Castellar del Vallès;1;;18928;4636;9156;10446;8482;172;67;10207;10274
8;Barcelona;2;Catalunya Central;14;Berguedà;08052;Castellar de n'Hug;1;;142;44;80;101;41;4;1;96;97
8;Barcelona;2;Catalunya Central;7;Bages;08053;Castellbell i el Vilar;1;;2949;595;1199;1364;1585;22;16;1326;1342
8;Barcelona;1;Barcelona;40;Vallès Occidental;08054;Castellbisbal;1;;9346;1928;4279;5010;4336;82;37;4891;4928
8;Barcelona;2;Catalunya Central;42;Moianès;08055;Castellcir;1;;542;162;296;340;202;5;8;327;335
25;Lleida;4;Lleida;18;Garrigues;25067;Castelldans;1;;683;176;361;398;285;9;9;380;389
8;Barcelona;1;Barcelona;11;Baix Llobregat;08056;Castelldefels;1;;11834;2204;4868;5809;6025;80;57;5672;5729
8;Barcelona;1;Barcelona;11;Baix Llobregat;08056;Castelldefels;2;;8043;1731;3523;4141;3902;64;55;4022;4077
8;Barcelona;1;Barcelona;11;Baix Llobregat;08056;Castelldefels;3;;7013;1571;3259;3862;3151;47;45;3770;3815
8;Barcelona;1;Barcelona;11;Baix Llobregat;08056;Castelldefels;4;;7915;1598;3558;4177;3738;34;39;4104;4143
8;Barcelona;1;Barcelona;11;Baix Llobregat;08056;Castelldefels;5;;8161;1674;3706;4414;3747;49;32;4333;4365
8;Barcelona;2;Catalunya Central;14;Berguedà;08057;Castell de l'Areny;1;;62;17;40;45;17;1;1;43;44
25;Lleida;5;Alt Pirineu i territori d'Aran;25;Pallars Jussà;25904;Castell de Mur;1;;150;39;80;106;44;0;1;105;106
8;Barcelona;8;Penedès;3;Alt Penedès;08058;Castellet i la Gornal;1;;1860;458;809;924;936;16;15;893;908
17;Girona;3;Girona;19;Garrotxa;17046;Castellfollit de la Roca;1;;713;240;379;423;290;7;8;408;416
8;Barcelona;2;Catalunya Central;7;Bages;08059;Castellfollit del Boix;1;;353;115;202;222;131;5;5;212;217
8;Barcelona;2;Catalunya Central;6;Anoia;08060;Castellfollit de Riubregós;1;;138;52;94;106;32;4;0;102;102
8;Barcelona;2;Catalunya Central;7;Bages;08061;Castellgalí;1;;1671;386;726;824;847;10;10;804;814
8;Barcelona;2;Catalunya Central;7;Bages;08062;Castellnou de Bages;1;;1044;278;575;674;370;10;6;658;664
25;Lleida;4;Lleida;27;Pla d'Urgell;25068;Castellnou de Seana;1;;524;157;251;297;227;5;3;289;292
17;Girona;3;Girona;2;Alt Empordà;17047;Castelló d'Empúries;1;;5051;961;2093;2433;2618;52;12;2369;2381
25;Lleida;4;Lleida;23;Noguera;25069;Castelló de Farfanya;1;;414;134;220;228;186;1;2;225;227
8;Barcelona;8;Penedès;6;Anoia;08063;Castellolí;1;;490;141;317;364;126;6;2;356;358
17;Girona;3;Girona;10;Baix Empordà;17048;Castell-Platja d'Aro;1;;6600;1632;2821;3380;3220;47;40;3293;3333
25;Lleida;4;Lleida;38;Urgell;25070;Castellserà;1;;784;216;449;488;296;11;12;465;477
8;Barcelona;2;Catalunya Central;42;Moianès;08064;Castellterçol;1;;1997;496;1024;1200;797;26;10;1164;1174
43;Tarragona;6;Camp de Tarragona;8;Baix Camp;43042;Castellvell del Camp;1;;2228;605;1223;1411;817;18;15;1378;1393
8;Barcelona;8;Penedès;3;Alt Penedès;08065;Castellví de la Marca;1;;1222;336;657;776;446;16;9;751;760
8;Barcelona;1;Barcelona;11;Baix Llobregat;08066;Castellví de Rosanes;1;;1496;417;785;930;566;13;12;905;917
43;Tarragona;6;Camp de Tarragona;36;Tarragonès;43043;Catllar, el;1;;3466;946;1730;1976;1490;26;9;1941;1950
25;Lleida;5;Alt Pirineu i territori d'Aran;4;Alt Urgell;25071;Cava;1;;41;23;29;32;9;1;0;31;31
17;Girona;3;Girona;34;Selva;17189;Cellera de Ter, la;1;;1499;538;983;1084;415;15;7;1062;1069
17;Girona;3;Girona;20;Gironès;17049;Celrà;1;;3283;764;1746;2059;1224;34;15;2010;2025
8;Barcelona;2;Catalunya Central;24;Osona;08067;Centelles;1;;5846;1463;2814;3418;2428;61;32;3325;3357
8;Barcelona;2;Catalunya Central;14;Berguedà;08268;Cercs;1;;979;291;497;583;396;12;3;568;571
8;Barcelona;1;Barcelona;40;Vallès Occidental;08266;Cerdanyola del Vallès;1;;43468;9997;20207;23985;19483;296;227;23462;23689
8;Barcelona;1;Barcelona;11;Baix Llobregat;08068;Cervelló;1;;6922;1614;3261;3826;3096;50;29;3747;3776
25;Lleida;4;Lleida;32;Segarra;25072;Cervera;1;;796;185;337;388;408;12;10;366;376
25;Lleida;4;Lleida;32;Segarra;25072;Cervera;2;;3354;802;1565;1837;1517;33;31;1773;1804
25;Lleida;4;Lleida;32;Segarra;25072;Cervera;3;;1810;370;809;947;863;13;15;919;934
25;Lleida;4;Lleida;18;Garrigues;25073;Cervià de les Garrigues;1;;556;176;307;340;216;9;3;328;331
17;Girona;3;Girona;20;Gironès;17050;Cervià de Ter;1;;677;258;454;503;174;5;5;493;498
17;Girona;3;Girona;2;Alt Empordà;17051;Cistella;1;;207;69;136;149;58;1;3;145;148
25;Lleida;4;Lleida;38;Urgell;25074;Ciutadilla;1;;174;78;115;125;49;2;2;121;123
25;Lleida;2;Catalunya Central;35;Solsonès;25075;Clariana de Cardener;1;;130;52;78;88;42;3;3;82;85
25;Lleida;4;Lleida;18;Garrigues;25076;Cogul, el;1;;132;44;78;90;42;0;0;90;90
17;Girona;3;Girona;2;Alt Empordà;17054;Colera;1;;344;128;188;220;124;4;1;215;216
8;Barcelona;1;Barcelona;11;Baix Llobregat;08069;Collbató;1;;3489;783;1741;2002;1487;22;37;1943;1980
43;Tarragona;6;Camp de Tarragona;8;Baix Camp;43045;Colldejou;1;;142;62;90;101;41;1;2;98;100
25;Lleida;5;Alt Pirineu i territori d'Aran;4;Alt Urgell;25077;Coll de Nargó;1;;433;125;218;274;159;12;3;259;262
8;Barcelona;2;Catalunya Central;42;Moianès;08070;Collsuspina;1;;289;122;206;220;69;4;4;212;216
17;Girona;3;Girona;10;Baix Empordà;17055;Colomers;1;;150;64;115;121;29;2;0;119;119
25;Lleida;2;Catalunya Central;35;Solsonès;25163;Coma i la Pedra, la;1;;241;49;110;138;103;1;2;135;137
25;Lleida;5;Alt Pirineu i territori d'Aran;25;Pallars Jussà;25161;Conca de Dalt;1;;338;88;161;213;125;4;2;207;209
43;Tarragona;6;Camp de Tarragona;16;Conca de Barberà;43046;Conesa;1;;89;35;53;61;28;1;2;58;60
43;Tarragona;6;Camp de Tarragona;36;Tarragonès;43047;Constantí;1;;2347;526;825;866;1481;13;9;844;853
43;Tarragona;6;Camp de Tarragona;36;Tarragonès;43047;Constantí;2;;1907;483;858;919;988;24;10;885;895
8;Barcelona;8;Penedès;6;Anoia;08071;Copons;1;;252;70;155;179;73;2;3;174;177
43;Tarragona;7;Terres de l'Ebre;37;Terra Alta;43048;Corbera d'Ebre;1;;753;250;397;454;299;14;13;427;440
8;Barcelona;1;Barcelona;11;Baix Llobregat;08072;Corbera de Llobregat;1;;10870;2309;4779;5619;5251;92;51;5476;5527
25;Lleida;4;Lleida;33;Segrià;25078;Corbins;1;;996;235;526;646;350;6;12;628;640
17;Girona;3;Girona;10;Baix Empordà;17057;Corçà;1;;979;381;624;692;287;26;2;664;666
8;Barcelona;1;Barcelona;11;Baix Llobregat;08073;Cornellà de Llobregat;1;;15703;3374;7215;8476;7227;95;56;8325;8381
8;Barcelona;1;Barcelona;11;Baix Llobregat;08073;Cornellà de Llobregat;2;;4681;850;2094;2563;2118;13;19;2531;2550
8;Barcelona;1;Barcelona;11;Baix Llobregat;08073;Cornellà de Llobregat;3;;10424;2163;4951;5750;4674;86;49;5615;5664
8;Barcelona;1;Barcelona;11;Baix Llobregat;08073;Cornellà de Llobregat;4;;16120;3756;7096;8049;8071;83;47;7919;7966
8;Barcelona;1;Barcelona;11;Baix Llobregat;08073;Cornellà de Llobregat;5;;6473;1306;2342;2617;3856;32;20;2565;2585
8;Barcelona;1;Barcelona;11;Baix Llobregat;08073;Cornellà de Llobregat;6;;9368;2202;3570;3931;5437;57;27;3847;3874
17;Girona;3;Girona;28;Pla de l'Estany;17056;Cornellà del Terri;1;;1782;539;1048;1150;632;23;4;1123;1127
43;Tarragona;6;Camp de Tarragona;29;Priorat;43049;Cornudella de Montsant;1;;737;251;441;504;233;8;2;494;496
43;Tarragona;6;Camp de Tarragona;36;Tarragonès;43050;Creixell;1;;2779;615;1043;1243;1536;16;10;1217;1227
17;Girona;3;Girona;28;Pla de l'Estany;17058;Crespià;1;;185;75;113;124;61;1;1;122;123
17;Girona;3;Girona;10;Baix Empordà;17901;Cruïlles, Monells i Sant Sadurní;1;;1024;351;606;664;360;12;13;639;652
8;Barcelona;8;Penedès;17;Garraf;08074;Cubelles;1;;11414;2779;4832;5499;5915;66;42;5391;5433
25;Lleida;4;Lleida;23;Noguera;25079;Cubells;1;;275;92;156;185;90;8;2;175;177
43;Tarragona;8;Penedès;12;Baix Penedès;43051;Cunit;1;;9595;2073;3631;4253;5342;125;31;4097;4128
17;Girona;3;Girona;2;Alt Empordà;17060;Darnius;1;;405;115;213;245;160;0;1;244;245
17;Girona;5;Alt Pirineu i territori d'Aran;15;Cerdanya;17061;Das;1;;171;49;88;121;50;5;2;114;116
43;Tarragona;7;Terres de l'Ebre;9;Baix Ebre;43901;Deltebre;1;;8813;1849;3208;3681;5132;413;23;3245;3268
8;Barcelona;1;Barcelona;21;Maresme;08075;Dosrius;1;;4230;949;1810;2145;2085;29;26;2090;2116
43;Tarragona;6;Camp de Tarragona;8;Baix Camp;43053;Duesaigües;1;;179;53;112;125;54;1;0;124;124
17;Girona;3;Girona;2;Alt Empordà;17062;Escala, l';1;;6063;1561;2624;3123;2940;47;26;3050;3076
8;Barcelona;1;Barcelona;11;Baix Llobregat;08076;Esparreguera;1;;8864;1746;4034;4603;4261;72;30;4501;4531
8;Barcelona;1;Barcelona;11;Baix Llobregat;08076;Esparreguera;2;;7832;1838;3236;3624;4208;34;35;3555;3590
17;Girona;2;Catalunya Central;24;Osona;17063;Espinelves;1;;182;78;132;153;29;2;0;151;151
25;Lleida;4;Lleida;18;Garrigues;25081;Espluga Calba, l';1;;270;69;148;173;97;6;6;161;167
43;Tarragona;6;Camp de Tarragona;16;Conca de Barberà;43054;Espluga de Francolí, l';1;;1640;360;707;902;738;16;6;880;886
43;Tarragona;6;Camp de Tarragona;16;Conca de Barberà;43054;Espluga de Francolí, l';2;;1159;213;495;620;539;7;3;610;613
8;Barcelona;1;Barcelona;11;Baix Llobregat;08077;Esplugues de Llobregat;1;;6346;1535;3200;3941;2405;47;30;3864;3894
8;Barcelona;1;Barcelona;11;Baix Llobregat;08077;Esplugues de Llobregat;10;;9917;2492;4228;4792;5125;59;31;4702;4733
8;Barcelona;1;Barcelona;11;Baix Llobregat;08077;Esplugues de Llobregat;2;;7165;1717;3298;3990;3175;37;34;3919;3953
8;Barcelona;1;Barcelona;11;Baix Llobregat;08077;Esplugues de Llobregat;3;;2737;600;1374;1578;1159;18;9;1551;1560
8;Barcelona;1;Barcelona;11;Baix Llobregat;08077;Esplugues de Llobregat;4;;565;127;340;396;169;2;1;393;394
8;Barcelona;1;Barcelona;11;Baix Llobregat;08077;Esplugues de Llobregat;5;;516;95;215;255;261;0;1;254;255
8;Barcelona;1;Barcelona;11;Baix Llobregat;08077;Esplugues de Llobregat;6;;545;130;267;311;234;2;0;309;309
8;Barcelona;1;Barcelona;11;Baix Llobregat;08077;Esplugues de Llobregat;7;;787;200;419;558;229;2;2;554;556
8;Barcelona;1;Barcelona;11;Baix Llobregat;08077;Esplugues de Llobregat;8;;3144;766;1537;1817;1327;13;15;1789;1804
8;Barcelona;1;Barcelona;11;Baix Llobregat;08077;Esplugues de Llobregat;9;;2674;586;1263;1521;1153;17;14;1490;1504
17;Girona;3;Girona;2;Alt Empordà;17064;Espolla;1;;323;124;215;234;89;6;1;227;228
17;Girona;3;Girona;28;Pla de l'Estany;17065;Esponellà;1;;327;122;225;231;96;4;2;225;227
25;Lleida;5;Alt Pirineu i territori d'Aran;26;Pallars Sobirà;25082;Espot;1;;301;70;138;197;104;11;7;179;186
8;Barcelona;2;Catalunya Central;14;Berguedà;08078;Espunyola, l';1;;220;50;118;140;80;3;5;132;137
8;Barcelona;2;Catalunya Central;24;Osona;08254;Esquirol, l';1;;1762;629;1083;1288;474;11;14;1263;1277
25;Lleida;5;Alt Pirineu i territori d'Aran;4;Alt Urgell;25088;Estamariu;1;;97;32;50;61;36;0;1;60;61
8;Barcelona;2;Catalunya Central;42;Moianès;08079;Estany, l';1;;338;141;232;249;89;5;5;239;244
25;Lleida;4;Lleida;32;Segarra;25085;Estaràs;1;;143;51;87;100;43;0;0;100;100
25;Lleida;5;Alt Pirineu i territori d'Aran;26;Pallars Sobirà;25086;Esterri d'Àneu;1;;554;125;374;391;163;14;6;371;377
25;Lleida;5;Alt Pirineu i territori d'Aran;26;Pallars Sobirà;25087;Esterri de Cardós;1;;53;18;25;39;14;0;1;38;39
43;Tarragona;6;Camp de Tarragona;29;Priorat;43055;Falset;1;;782;278;459;549;233;15;2;532;534
43;Tarragona;6;Camp de Tarragona;29;Priorat;43055;Falset;2;;1171;371;647;812;359;16;7;789;796
17;Girona;3;Girona;2;Alt Empordà;17005;Far d'Empordà, el;1;;464;111;247;277;187;6;4;267;271
25;Lleida;5;Alt Pirineu i territori d'Aran;26;Pallars Sobirà;25089;Farrera;1;;91;29;29;58;33;0;0;58;58
43;Tarragona;7;Terres de l'Ebre;37;Terra Alta;43056;Fatarella, la;1;;791;219;444;507;284;17;8;482;490
43;Tarragona;6;Camp de Tarragona;8;Baix Camp;43057;Febró, la;1;;39;11;22;28;11;0;1;27;28
8;Barcelona;1;Barcelona;41;Vallès Oriental;08134;Figaró-Montmany;1;;862;254;456;519;343;9;2;508;510
8;Barcelona;2;Catalunya Central;14;Berguedà;08080;Fígols;1;;38;13;21;27;11;0;2;25;27
25;Lleida;5;Alt Pirineu i territori d'Aran;4;Alt Urgell;25908;Fígols i Alinyà;1;;218;64;106;128;90;4;1;123;124
43;Tarragona;6;Camp de Tarragona;29;Priorat;43058;Figuera, la;1;;99;46;65;77;22;0;1;76;77
17;Girona;3;Girona;2;Alt Empordà;17066;Figueres;1;;7931;1332;2640;3038;4893;51;27;2960;2987
17;Girona;3;Girona;2;Alt Empordà;17066;Figueres;2;;3931;870;1652;1857;2074;25;15;1817;1832
17;Girona;3;Girona;2;Alt Empordà;17066;Figueres;3;;6459;1272;2396;2880;3579;51;19;2810;2829
17;Girona;3;Girona;2;Alt Empordà;17066;Figueres;4;;9008;1742;3584;4279;4729;59;27;4193;4220
43;Tarragona;6;Camp de Tarragona;1;Alt Camp;43059;Figuerola del Camp;1;;263;88;150;160;103;0;3;157;160
17;Girona;3;Girona;20;Gironès;17067;Flaçà;1;;693;213;458;482;211;4;10;468;478
43;Tarragona;7;Terres de l'Ebre;30;Ribera d'Ebre;43060;Flix;1;;1821;540;914;1156;665;22;7;1127;1134
43;Tarragona;7;Terres de l'Ebre;30;Ribera d'Ebre;43060;Flix;2;;829;237;418;498;331;12;8;478;486
25;Lleida;4;Lleida;18;Garrigues;25092;Floresta, la;1;;126;52;84;96;30;1;2;93;95
8;Barcelona;3;Girona;34;Selva;08082;Fogars de la Selva;1;;1210;300;533;587;623;6;8;573;581
8;Barcelona;1;Barcelona;41;Vallès Oriental;08081;Fogars de Montclús;1;;354;124;217;244;110;1;3;240;243
17;Girona;3;Girona;10;Baix Empordà;17068;Foixà;1;;252;105;155;178;74;6;1;171;172
8;Barcelona;2;Catalunya Central;24;Osona;08083;Folgueroles;1;;1712;460;1135;1316;396;15;6;1295;1301
25;Lleida;4;Lleida;27;Pla d'Urgell;25093;Fondarella;1;;610;194;352;381;229;17;3;361;364
8;Barcelona;2;Catalunya Central;7;Bages;08084;Fonollosa;1;;1197;317;641;743;454;7;8;728;736
17;Girona;5;Alt Pirineu i territori d'Aran;15;Cerdanya;17069;Fontanals de Cerdanya;1;;403;131;212;264;139;7;2;255;257
17;Girona;3;Girona;10;Baix Empordà;17070;Fontanilles;1;;115;59;76;86;29;0;2;84;86
17;Girona;3;Girona;28;Pla de l'Estany;17071;Fontcoberta;1;;1131;397;743;825;306;13;10;802;812
8;Barcelona;8;Penedès;3;Alt Penedès;08085;Font-rubí;1;;1012;331;598;644;368;7;2;635;637
25;Lleida;4;Lleida;23;Noguera;25094;Foradada;1;;130;47;73;87;43;1;2;84;86
17;Girona;3;Girona;10;Baix Empordà;17902;Forallac;1;;1310;461;784;871;439;16;11;844;855
43;Tarragona;6;Camp de Tarragona;16;Conca de Barberà;43061;Forès;1;;40;17;21;25;15;0;0;25;25
17;Girona;3;Girona;20;Gironès;17073;Fornells de la Selva;1;;1987;614;1287;1466;521;29;9;1428;1437
17;Girona;3;Girona;2;Alt Empordà;17074;Fortià;1;;559;179;319;357;202;12;3;342;345
8;Barcelona;1;Barcelona;41;Vallès Oriental;08086;Franqueses del Vallès, les;1;;12423;2418;4909;5847;6576;82;56;5709;5765
8;Barcelona;1;Barcelona;41;Vallès Oriental;08086;Franqueses del Vallès, les;2;;1828;562;1040;1178;650;17;14;1147;1161
43;Tarragona;7;Terres de l'Ebre;22;Montsià;43062;Freginals;1;;264;124;164;181;83;4;5;172;177
25;Lleida;4;Lleida;38;Urgell;25096;Fuliola, la;1;;866;191;349;472;394;9;3;460;463
25;Lleida;4;Lleida;18;Garrigues;25097;Fulleda;1;;94;32;50;60;34;3;2;55;57
8;Barcelona;2;Catalunya Central;7;Bages;08090;Gaià;1;;138;55;90;101;37;3;0;98;98
43;Tarragona;7;Terres de l'Ebre;22;Montsià;43063;Galera, la;1;;531;135;236;267;264;8;0;259;259
8;Barcelona;1;Barcelona;40;Vallès Occidental;08087;Gallifa;1;;151;57;99;117;34;0;0;117;117
43;Tarragona;7;Terres de l'Ebre;37;Terra Alta;43064;Gandesa;1;;1203;323;573;715;488;24;5;686;691
43;Tarragona;7;Terres de l'Ebre;37;Terra Alta;43064;Gandesa;2;;849;242;410;530;319;10;2;518;520
43;Tarragona;7;Terres de l'Ebre;30;Ribera d'Ebre;43065;Garcia;1;;382;114;231;255;127;10;3;242;245
43;Tarragona;6;Camp de Tarragona;1;Alt Camp;43066;Garidells, els;1;;164;58;99;108;56;0;2;106;108
8;Barcelona;1;Barcelona;41;Vallès Oriental;08088;Garriga, la;1;;5443;1304;2747;3138;2305;54;19;3065;3084
8;Barcelona;1;Barcelona;41;Vallès Oriental;08088;Garriga, la;2;;7003;1676;3751;4364;2639;55;50;4259;4309
17;Girona;3;Girona;2;Alt Empordà;17075;Garrigàs;1;;340;92;191;224;116;11;4;209;213
17;Girona;3;Girona;10;Baix Empordà;17076;Garrigoles;1;;122;53;78;90;32;2;1;87;88
17;Girona;3;Girona;2;Alt Empordà;17077;Garriguella;1;;581;202;301;351;230;5;2;344;346
8;Barcelona;1;Barcelona;11;Baix Llobregat;08089;Gavà;1;;10309;1852;4590;5401;4908;72;54;5275;5329
8;Barcelona;1;Barcelona;11;Baix Llobregat;08089;Gavà;2;;10921;2171;4533;5174;5747;57;44;5073;5117
8;Barcelona;1;Barcelona;11;Baix Llobregat;08089;Gavà;3;;9903;2013;4109;4770;5133;67;52;4651;4703
8;Barcelona;1;Barcelona;11;Baix Llobregat;08089;Gavà;4;;2991;680;1263;1449;1542;17;6;1426;1432
25;Lleida;5;Alt Pirineu i territori d'Aran;25;Pallars Jussà;25098;Gavet de la Conca;1;;233;54;107;142;91;3;3;136;139
8;Barcelona;8;Penedès;3;Alt Penedès;08091;Gelida;1;;3610;779;1568;1987;1623;19;17;1951;1968
8;Barcelona;8;Penedès;3;Alt Penedès;08091;Gelida;2;;1917;379;829;1051;866;18;13;1020;1033
17;Girona;5;Alt Pirineu i territori d'Aran;15;Cerdanya;17078;Ger;1;;379;115;221;274;105;7;1;266;267
25;Lleida;4;Lleida;33;Segrià;25912;Gimenells i el Pla de la Font;1;;835;239;444;536;299;9;8;519;527
43;Tarragona;7;Terres de l'Ebre;30;Ribera d'Ebre;43067;Ginestar;1;;534;222;346;388;146;11;5;372;377
17;Girona;3;Girona;20;Gironès;17079;Girona;1;;5024;1106;1996;2402;2622;35;22;2345;2367
17;Girona;3;Girona;20;Gironès;17079;Girona;2;;24598;5247;12617;15841;8757;224;111;15506;15617
17;Girona;3;Girona;20;Gironès;17079;Girona;3;;22817;4751;10397;12441;10376;166;100;12175;12275
17;Girona;3;Girona;20;Gironès;17079;Girona;4;;1408;274;633;758;650;13;6;739;745
17;Girona;3;Girona;20;Gironès;17079;Girona;5;;5130;1433;2707;3106;2024;52;19;3035;3054
17;Girona;3;Girona;20;Gironès;17079;Girona;6;;6763;1403;2903;3330;3433;61;25;3244;3269
8;Barcelona;2;Catalunya Central;14;Berguedà;08092;Gironella;1;;1243;250;648;760;483;15;2;743;745
8;Barcelona;2;Catalunya Central;14;Berguedà;08092;Gironella;2;;2451;620;1236;1412;1039;23;8;1381;1389
8;Barcelona;2;Catalunya Central;14;Berguedà;08093;Gisclareny;1;;25;8;14;21;4;0;1;20;21
43;Tarragona;7;Terres de l'Ebre;22;Montsià;43068;Godall;1;;493;112;201;238;255;6;0;232;232
25;Lleida;4;Lleida;27;Pla d'Urgell;25099;Golmés;1;;1305;317;600;721;584;7;6;708;714
17;Girona;3;Girona;31;Ripollès;17080;Gombrèn;1;;145;37;68;87;58;0;0;87;87
25;Lleida;2;Catalunya Central;14;Berguedà;25100;Gósol;1;;187;56;108;131;56;1;1;129;130
8;Barcelona;8;Penedès;3;Alt Penedès;08094;Granada, la;1;;1631;350;871;1018;613;14;13;991;1004
25;Lleida;4;Lleida;18;Garrigues;25101;Granadella, la;1;;521;175;312;361;160;2;5;354;359
8;Barcelona;2;Catalunya Central;42;Moianès;08095;Granera;1;;75;30;40;54;21;0;2;52;54
25;Lleida;4;Lleida;33;Segrià;25102;Granja d'Escarp, la;1;;628;209;349;395;233;10;6;379;385
8;Barcelona;1;Barcelona;41;Vallès Oriental;08096;Granollers;1;;11128;2878;5283;5912;5216;98;50;5764;5814
8;Barcelona;1;Barcelona;41;Vallès Oriental;08096;Granollers;2;;8036;2204;3947;4534;3502;48;28;4458;4486
8;Barcelona;1;Barcelona;41;Vallès Oriental;08096;Granollers;3;;11501;2929;5561;6316;5185;81;61;6174;6235
8;Barcelona;1;Barcelona;41;Vallès Oriental;08096;Granollers;4;;13344;3459;6651;7419;5925;97;63;7259;7322
25;Lleida;4;Lleida;32;Segarra;25103;Granyanella;1;;131;35;61;73;58;1;3;69;72
25;Lleida;4;Lleida;18;Garrigues;25105;Granyena de les Garrigues;1;;112;56;84;91;21;5;2;84;86
25;Lleida;4;Lleida;32;Segarra;25104;Granyena de Segarra;1;;130;42;72;79;51;0;0;79;79
43;Tarragona;6;Camp de Tarragona;29;Priorat;43069;Gratallops;1;;192;68;111;139;53;10;0;129;129
8;Barcelona;1;Barcelona;41;Vallès Oriental;08097;Gualba;1;;1118;354;651;725;393;7;2;716;718
17;Girona;3;Girona;10;Baix Empordà;17081;Gualta;1;;269;114;173;188;81;5;1;182;183
8;Barcelona;2;Catalunya Central;14;Berguedà;08099;Guardiola de Berguedà;1;;762;194;403;467;295;10;2;455;457
43;Tarragona;6;Camp de Tarragona;29;Priorat;43070;Guiamets, els;1;;247;101;167;177;70;0;0;177;177
17;Girona;5;Alt Pirineu i territori d'Aran;15;Cerdanya;17082;Guils de Cerdanya;1;;466;106;215;278;188;14;3;261;264
25;Lleida;4;Lleida;38;Urgell;25109;Guimerà;1;;208;81;122;141;67;0;3;138;141
25;Lleida;5;Alt Pirineu i territori d'Aran;26;Pallars Sobirà;25903;Guingueta d'Àneu, la;1;;226;53;106;159;67;0;2;157;159
25;Lleida;4;Lleida;32;Segarra;25110;Guissona;1;;2742;624;1307;1542;1200;33;16;1493;1509
25;Lleida;2;Catalunya Central;35;Solsonès;25111;Guixers;1;;110;35;62;73;37;3;1;69;70
8;Barcelona;2;Catalunya Central;24;Osona;08100;Gurb;1;;2111;660;1345;1547;564;8;21;1518;1539
43;Tarragona;7;Terres de l'Ebre;37;Terra Alta;43071;Horta de Sant Joan;1;;877;214;401;487;390;14;5;468;473
8;Barcelona;1;Barcelona;13;Barcelonès;08101;Hospitalet de Llobregat, l';1;;38634;8436;17455;20565;18069;319;148;20098;20246
8;Barcelona;1;Barcelona;13;Barcelonès;08101;Hospitalet de Llobregat, l';2;;29810;5639;11033;12560;17250;176;96;12288;12384
8;Barcelona;1;Barcelona;13;Barcelonès;08101;Hospitalet de Llobregat, l';3;;31859;7042;14512;16728;15131;210;117;16401;16518
8;Barcelona;1;Barcelona;13;Barcelonès;08101;Hospitalet de Llobregat, l';4;;25418;4771;8918;10037;15381;161;62;9814;9876
8;Barcelona;1;Barcelona;13;Barcelonès;08101;Hospitalet de Llobregat, l';5;;24346;5297;9133;10431;13915;139;77;10215;10292
8;Barcelona;1;Barcelona;13;Barcelonès;08101;Hospitalet de Llobregat, l';6;;23562;5210;9716;11381;12181;145;97;11139;11236
8;Barcelona;8;Penedès;6;Anoia;08162;Hostalets de Pierola, els;1;;2163;511;1000;1148;1015;15;8;1125;1133
17;Girona;3;Girona;34;Selva;17083;Hostalric;1;;2998;713;1421;1545;1453;22;12;1511;1523
8;Barcelona;8;Penedès;6;Anoia;08102;Igualada;1;;1290;288;497;577;713;10;5;562;567
8;Barcelona;8;Penedès;6;Anoia;08102;Igualada;2;;2867;718;1396;1655;1212;19;20;1616;1636
8;Barcelona;8;Penedès;6;Anoia;08102;Igualada;3;;12514;3050;6251;7295;5219;85;67;7143;7210
8;Barcelona;8;Penedès;6;Anoia;08102;Igualada;4;;4468;1329;2273;2622;1846;36;26;2560;2586
8;Barcelona;8;Penedès;6;Anoia;08102;Igualada;5;;7845;1843;3673;4168;3677;60;38;4070;4108
25;Lleida;5;Alt Pirineu i territori d'Aran;25;Pallars Jussà;25115;Isona i Conca Dellà;1;;817;224;435;528;289;12;3;513;516
17;Girona;5;Alt Pirineu i territori d'Aran;15;Cerdanya;17084;Isòvol;1;;248;70;118;157;91;3;1;153;154
25;Lleida;4;Lleida;27;Pla d'Urgell;25113;Ivars d'Urgell;1;;1116;399;638;718;398;17;16;685;701
25;Lleida;4;Lleida;23;Noguera;25112;Ivars de Noguera;1;;265;111;162;176;89;4;3;169;172
25;Lleida;4;Lleida;32;Segarra;25114;Ivorra;1;;105;48;75;83;22;1;1;81;82
17;Girona;3;Girona;10;Baix Empordà;17085;Jafre;1;;289;115;197;223;66;2;5;216;221
17;Girona;3;Girona;2;Alt Empordà;17086;Jonquera, la;1;;1740;405;718;818;922;19;6;793;799
8;Barcelona;8;Penedès;6;Anoia;08103;Jorba;1;;650;133;331;381;269;6;4;371;375
25;Lleida;5;Alt Pirineu i territori d'Aran;4;Alt Urgell;25910;Josa i Tuixén;1;;93;20;40;61;32;1;0;60;60
17;Girona;3;Girona;20;Gironès;17087;Juià;1;;224;83;139;165;59;5;1;159;160
25;Lleida;4;Lleida;18;Garrigues;25118;Juncosa;1;;316;99;144;166;150;5;6;155;161
25;Lleida;4;Lleida;18;Garrigues;25119;Juneda;1;;2267;669;1125;1377;890;32;17;1328;1345
25;Lleida;5;Alt Pirineu i territori d'Aran;39;Consell General d'Aran;25121;Les;1;;656;113;237;316;340;22;2;292;294
25;Lleida;4;Lleida;27;Pla d'Urgell;25122;Linyola;1;;1934;427;894;1057;877;16;19;1022;1041
8;Barcelona;8;Penedès;6;Anoia;08104;Llacuna, la;1;;675;232;369;431;244;5;5;421;426
17;Girona;3;Girona;2;Alt Empordà;17088;Lladó;1;;608;165;373;406;202;10;7;389;396
25;Lleida;5;Alt Pirineu i territori d'Aran;26;Pallars Sobirà;25123;Lladorre;1;;195;21;61;139;56;4;2;133;135
25;Lleida;2;Catalunya Central;35;Solsonès;25124;Lladurs;1;;157;47;84;98;59;3;0;95;95
8;Barcelona;1;Barcelona;41;Vallès Oriental;08105;Llagosta, la;1;;9660;2147;3989;4634;5026;78;47;4509;4556
17;Girona;3;Girona;20;Gironès;17089;Llagostera;1;;5865;1211;2544;2979;2886;39;24;2916;2940
17;Girona;3;Girona;20;Gironès;17090;Llambilles;1;;560;180;353;411;149;1;4;406;410
17;Girona;3;Girona;31;Ripollès;17091;Llanars;1;;405;127;216;256;149;10;2;244;246
17;Girona;3;Girona;2;Alt Empordà;17092;Llançà;1;;3523;867;1522;1813;1710;40;21;1752;1773
25;Lleida;4;Lleida;33;Segrià;25125;Llardecans;1;;373;116;217;241;132;4;3;234;237
25;Lleida;5;Alt Pirineu i territori d'Aran;26;Pallars Sobirà;25126;Llavorsí;1;;282;69;137;190;92;2;2;186;188
25;Lleida;4;Lleida;33;Segrià;25120;Lleida;1;;17255;3595;7317;8511;8744;158;90;8263;8353
25;Lleida;4;Lleida;33;Segrià;25120;Lleida;2;;10830;2081;4829;5732;5098;79;43;5610;5653
25;Lleida;4;Lleida;33;Segrià;25120;Lleida;3;;5451;1468;2590;2979;2472;43;17;2919;2936
25;Lleida;4;Lleida;33;Segrià;25120;Lleida;4;;13654;2934;4959;5884;7770;102;56;5726;5782
25;Lleida;4;Lleida;33;Segrià;25120;Lleida;5;;9465;2203;4616;5645;3820;43;66;5536;5602
25;Lleida;4;Lleida;33;Segrià;25120;Lleida;6;;17054;3879;7393;8490;8564;147;83;8260;8343
25;Lleida;4;Lleida;33;Segrià;25120;Lleida;7;;11690;2309;4515;5114;6576;96;67;4951;5018
25;Lleida;4;Lleida;33;Segrià;25120;Lleida;8;;4315;1070;2259;2641;1674;35;23;2583;2606
25;Lleida;4;Lleida;33;Segrià;25120;Lleida;9;;2674;726;1287;1437;1237;21;8;1408;1416
17;Girona;3;Girona;2;Alt Empordà;17093;Llers;1;;935;262;501;564;371;8;7;549;556
25;Lleida;5;Alt Pirineu i territori d'Aran;15;Cerdanya;25127;Lles de Cerdanya;1;;229;62;112;144;85;5;2;137;139
8;Barcelona;1;Barcelona;41;Vallès Oriental;08107;Lliçà d'Amunt;1;;12188;2319;4975;5596;6592;83;47;5466;5513
8;Barcelona;1;Barcelona;41;Vallès Oriental;08108;Lliçà de Vall;1;;5243;1581;2704;2822;2421;36;40;2746;2786
25;Lleida;5;Alt Pirineu i territori d'Aran;25;Pallars Jussà;25128;Llimiana;1;;131;37;68;80;51;1;0;79;79
8;Barcelona;1;Barcelona;41;Vallès Oriental;08106;Llinars del Vallès;1;;2663;625;1131;1300;1363;18;9;1273;1282
8;Barcelona;1;Barcelona;41;Vallès Oriental;08106;Llinars del Vallès;2;;4937;1301;2394;2758;2179;46;19;2693;2712
17;Girona;5;Alt Pirineu i territori d'Aran;15;Cerdanya;17094;Llívia;1;;1100;263;477;616;484;22;4;590;594
43;Tarragona;6;Camp de Tarragona;29;Priorat;43072;Lloar, el;1;;91;34;59;69;22;2;2;65;67
25;Lleida;2;Catalunya Central;35;Solsonès;25129;Llobera;1;;157;44;84;96;61;2;2;92;94
43;Tarragona;6;Camp de Tarragona;16;Conca de Barberà;43073;Llorac;1;;80;23;43;56;24;1;1;54;55
43;Tarragona;8;Penedès;12;Baix Penedès;43074;Llorenç del Penedès;1;;1870;480;945;1075;795;14;7;1054;1061
17;Girona;3;Girona;34;Selva;17095;Lloret de Mar;1;;4686;798;1654;2069;2617;39;19;2011;2030
17;Girona;3;Girona;34;Selva;17095;Lloret de Mar;2;;4081;861;1708;2080;2001;35;8;2037;2045
17;Girona;3;Girona;34;Selva;17095;Lloret de Mar;3;;6572;1435;2804;2992;3580;64;33;2895;2928
17;Girona;3;Girona;34;Selva;17095;Lloret de Mar;4;;4784;867;1808;2206;2578;54;21;2131;2152
17;Girona;3;Girona;31;Ripollès;17096;Llosses, les;1;;161;49;81;95;66;1;3;91;94
8;Barcelona;2;Catalunya Central;24;Osona;08109;Lluçà;1;;206;82;149;162;44;3;2;157;159
17;Girona;3;Girona;2;Alt Empordà;17102;Maçanet de Cabrenys;1;;571;174;340;386;185;13;1;372;373
17;Girona;3;Girona;34;Selva;17103;Maçanet de la Selva;1;;5237;1047;1820;2143;3094;28;12;2103;2115
17;Girona;3;Girona;20;Gironès;17097;Madremanya;1;;203;86;132;151;52;3;0;148;148
17;Girona;3;Girona;19;Garrotxa;17098;Maià de Montcal;1;;308;102;180;191;117;6;0;185;185
25;Lleida;4;Lleida;33;Segrià;25133;Maials;1;;669;188;334;398;271;6;3;389;392
25;Lleida;4;Lleida;38;Urgell;25130;Maldà;1;;195;65;110;125;70;0;1;124;125
8;Barcelona;1;Barcelona;21;Maresme;08110;Malgrat de Mar;1;;9386;2131;4020;4541;4845;80;45;4416;4461
8;Barcelona;1;Barcelona;21;Maresme;08110;Malgrat de Mar;2;;4429;954;1934;2243;2186;23;27;2193;2220
8;Barcelona;2;Catalunya Central;24;Osona;08111;Malla;1;;220;102;171;189;31;2;5;182;187
8;Barcelona;2;Catalunya Central;24;Osona;08112;Manlleu;1;;2092;545;1066;1228;864;21;7;1200;1207
8;Barcelona;2;Catalunya Central;24;Osona;08112;Manlleu;2;;4093;1180;1926;2166;1927;21;22;2123;2145
8;Barcelona;2;Catalunya Central;24;Osona;08112;Manlleu;3;;4678;979;1920;2200;2478;24;25;2151;2176
8;Barcelona;2;Catalunya Central;24;Osona;08112;Manlleu;4;;2038;542;1043;1190;848;17;7;1166;1173
8;Barcelona;2;Catalunya Central;7;Bages;08113;Manresa;1;;1123;277;520;594;529;8;3;583;586
8;Barcelona;2;Catalunya Central;7;Bages;08113;Manresa;2;;15276;3728;7558;8658;6618;80;50;8528;8578
8;Barcelona;2;Catalunya Central;7;Bages;08113;Manresa;3;;4498;989;2040;2319;2179;27;25;2267;2292
8;Barcelona;2;Catalunya Central;7;Bages;08113;Manresa;4;;14899;3633;7288;8291;6608;102;55;8134;8189
8;Barcelona;2;Catalunya Central;7;Bages;08113;Manresa;5;;14623;3133;6116;6887;7736;87;67;6733;6800
8;Barcelona;2;Catalunya Central;7;Bages;08113;Manresa;6;;1453;323;586;648;805;7;10;631;641
43;Tarragona;6;Camp de Tarragona;29;Priorat;43076;Marçà;1;;460;154;264;315;145;3;4;308;312
43;Tarragona;6;Camp de Tarragona;29;Priorat;43075;Margalef;1;;85;45;49;55;30;2;1;52;53
8;Barcelona;2;Catalunya Central;7;Bages;08242;Marganell;1;;226;68;104;135;91;0;0;135;135
8;Barcelona;1;Barcelona;11;Baix Llobregat;08114;Martorell;1;;2784;614;1214;1374;1410;12;9;1353;1362
8;Barcelona;1;Barcelona;11;Baix Llobregat;08114;Martorell;2;;1826;360;702;800;1026;13;5;782;787
8;Barcelona;1;Barcelona;11;Baix Llobregat;08114;Martorell;3;;8072;1919;3586;4030;4042;53;48;3929;3977
8;Barcelona;1;Barcelona;11;Baix Llobregat;08114;Martorell;4;;6279;1624;3113;3524;2755;54;23;3447;3470
8;Barcelona;1;Barcelona;41;Vallès Oriental;08115;Martorelles;1;;3836;850;1593;1900;1936;30;12;1858;1870
17;Girona;3;Girona;2;Alt Empordà;17100;Masarac;1;;197;68;119;131;66;2;1;128;129
43;Tarragona;7;Terres de l'Ebre;22;Montsià;43077;Mas de Barberans;1;;440;111;188;229;211;7;1;221;222
43;Tarragona;7;Terres de l'Ebre;22;Montsià;43078;Masdenverge;1;;858;254;386;480;378;7;9;464;473
8;Barcelona;2;Catalunya Central;24;Osona;08116;Masies de Roda, les;1;;555;224;354;381;174;2;4;375;379
8;Barcelona;2;Catalunya Central;24;Osona;08117;Masies de Voltregà, les;1;;1871;613;1070;1201;670;15;11;1175;1186
8;Barcelona;2;Catalunya Central;24;Osona;08117;Masies de Voltregà, les;2;;646;200;351;383;263;5;5;373;378
43;Tarragona;8;Penedès;12;Baix Penedès;43079;Masllorenç;1;;373;142;229;256;117;8;0;248;248
8;Barcelona;1;Barcelona;21;Maresme;08118;Masnou, el;1;;12587;3015;6491;7536;5051;119;49;7368;7417
8;Barcelona;1;Barcelona;21;Maresme;08118;Masnou, el;2;;5086;1235;2778;3220;1866;49;18;3153;3171
43;Tarragona;6;Camp de Tarragona;1;Alt Camp;43080;Masó, la;1;;233;80;152;167;66;4;2;161;163
43;Tarragona;6;Camp de Tarragona;8;Baix Camp;43081;Maspujols;1;;634;172;359;419;215;9;7;403;410
8;Barcelona;8;Penedès;6;Anoia;08119;Masquefa;1;;7156;1562;2861;3324;3832;41;35;3248;3283
43;Tarragona;6;Camp de Tarragona;29;Priorat;43082;Masroig, el;1;;345;102;199;246;99;8;2;236;238
25;Lleida;4;Lleida;33;Segrià;25131;Massalcoreig;1;;390;134;208;242;148;18;2;222;224
17;Girona;3;Girona;34;Selva;17101;Massanes;1;;588;165;260;298;290;5;3;290;293
25;Lleida;4;Lleida;32;Segarra;25132;Massoteres;1;;133;37;72;84;49;2;3;79;82
8;Barcelona;1;Barcelona;40;Vallès Occidental;08120;Matadepera;1;;7283;1546;3828;4886;2397;37;51;4798;4849
8;Barcelona;1;Barcelona;21;Maresme;08121;Mataró;1;;9783;2518;5483;6274;3509;54;47;6173;6220
8;Barcelona;1;Barcelona;21;Maresme;08121;Mataró;2;;13672;3216;6739;7628;6044;73;58;7497;7555
8;Barcelona;1;Barcelona;21;Maresme;08121;Mataró;3;;15920;3459;6778;7586;8334;98;61;7427;7488
8;Barcelona;1;Barcelona;21;Maresme;08121;Mataró;4;;11569;2207;4627;5283;6286;75;49;5159;5208
8;Barcelona;1;Barcelona;21;Maresme;08121;Mataró;5;;19127;3822;6904;7840;11287;113;65;7662;7727
8;Barcelona;1;Barcelona;21;Maresme;08121;Mataró;6;;17554;3863;7504;9069;8485;87;71;8911;8982
8;Barcelona;8;Penedès;3;Alt Penedès;08122;Mediona;1;;1772;410;710;846;926;7;9;830;839
25;Lleida;4;Lleida;23;Noguera;25134;Menàrguens;1;;598;186;339;388;210;16;2;370;372
17;Girona;5;Alt Pirineu i territori d'Aran;15;Cerdanya;17099;Meranges;1;;78;33;41;58;20;6;1;51;52
17;Girona;3;Girona;19;Garrotxa;17105;Mieres;1;;269;82;146;171;98;4;9;158;167
43;Tarragona;6;Camp de Tarragona;1;Alt Camp;43083;Milà, el;1;;149;51;75;91;58;1;0;90;90
25;Lleida;4;Lleida;27;Pla d'Urgell;25135;Miralcamp;1;;990;216;423;554;436;17;6;531;537
43;Tarragona;7;Terres de l'Ebre;30;Ribera d'Ebre;43084;Miravet;1;;512;150;297;341;171;12;7;322;329
8;Barcelona;2;Catalunya Central;42;Moianès;08138;Moià;1;;4577;944;2142;2603;1974;37;28;2538;2566
43;Tarragona;6;Camp de Tarragona;29;Priorat;43085;Molar, el;1;;230;79;145;165;65;8;1;156;157
8;Barcelona;1;Barcelona;11;Baix Llobregat;08123;Molins de Rei;1;;3740;995;1964;2301;1439;22;14;2265;2279
8;Barcelona;1;Barcelona;11;Baix Llobregat;08123;Molins de Rei;2;;6464;1631;3355;3845;2619;53;37;3755;3792
8;Barcelona;1;Barcelona;11;Baix Llobregat;08123;Molins de Rei;3;;8585;2167;4709;5461;3124;64;36;5361;5397
8;Barcelona;1;Barcelona;11;Baix Llobregat;08123;Molins de Rei;4;;820;218;379;433;387;9;4;420;424
25;Lleida;4;Lleida;27;Pla d'Urgell;25137;Mollerussa;1;;8648;1743;3643;4284;4364;102;25;4157;4182
8;Barcelona;1;Barcelona;41;Vallès Oriental;08124;Mollet del Vallès;1;;8602;1918;3723;4321;4281;65;27;4229;4256
8;Barcelona;1;Barcelona;41;Vallès Oriental;08124;Mollet del Vallès;2;;11149;2553;5169;5894;5255;107;28;5759;5787
8;Barcelona;1;Barcelona;41;Vallès Oriental;08124;Mollet del Vallès;3;;17525;3780;7209;8396;9129;139;72;8185;8257
17;Girona;3;Girona;2;Alt Empordà;17106;Mollet de Peralada;1;;144;52;94;104;40;1;0;103;103
17;Girona;3;Girona;31;Ripollès;17107;Molló;1;;271;100;154;186;85;11;2;173;175
25;Lleida;2;Catalunya Central;35;Solsonès;25136;Molsosa, la;1;;95;28;64;67;28;4;0;63;63
8;Barcelona;2;Catalunya Central;42;Moianès;08128;Monistrol de Calders;1;;597;174;312;356;241;4;2;350;352
8;Barcelona;2;Catalunya Central;7;Bages;08127;Monistrol de Montserrat;1;;2280;507;925;1106;1174;21;5;1080;1085
17;Girona;3;Girona;19;Garrotxa;17109;Montagut i Oix;1;;725;217;375;430;295;7;8;415;423
43;Tarragona;6;Camp de Tarragona;16;Conca de Barberà;43086;Montblanc;1;;1010;233;399;484;526;5;7;472;479
43;Tarragona;6;Camp de Tarragona;16;Conca de Barberà;43086;Montblanc;2;;4280;987;1959;2388;1892;46;24;2318;2342
43;Tarragona;6;Camp de Tarragona;8;Baix Camp;43088;Montbrió del Camp;1;;2041;497;932;1107;934;17;5;1085;1090
8;Barcelona;1;Barcelona;40;Vallès Occidental;08125;Montcada i Reixac;1;;4364;1050;1970;2281;2083;39;20;2222;2242
8;Barcelona;1;Barcelona;40;Vallès Occidental;08125;Montcada i Reixac;2;;4527;855;1875;2192;2335;32;22;2138;2160
8;Barcelona;1;Barcelona;40;Vallès Occidental;08125;Montcada i Reixac;3;;8518;1719;3730;4319;4199;54;29;4236;4265
8;Barcelona;1;Barcelona;40;Vallès Occidental;08125;Montcada i Reixac;4;;2541;552;1206;1332;1209;14;9;1309;1318
8;Barcelona;1;Barcelona;40;Vallès Occidental;08125;Montcada i Reixac;5;;3460;517;1085;1240;2220;20;13;1207;1220
8;Barcelona;1;Barcelona;40;Vallès Occidental;08125;Montcada i Reixac;6;;2325;474;1087;1205;1120;23;8;1174;1182
8;Barcelona;2;Catalunya Central;14;Berguedà;08130;Montclar;1;;107;12;50;69;38;3;1;65;66
25;Lleida;5;Alt Pirineu i territori d'Aran;15;Cerdanya;25139;Montellà i Martinet;1;;487;150;235;306;181;9;8;289;297
8;Barcelona;2;Catalunya Central;24;Osona;08131;Montesquiu;1;;747;206;402;474;273;5;10;459;469
25;Lleida;5;Alt Pirineu i territori d'Aran;4;Alt Urgell;25140;Montferrer i Castellbò;1;;798;194;375;444;354;7;8;429;437
43;Tarragona;6;Camp de Tarragona;1;Alt Camp;43089;Montferri;1;;289;75;130;145;144;1;2;142;144
25;Lleida;4;Lleida;23;Noguera;25138;Montgai;1;;572;202;329;363;209;9;9;345;354
8;Barcelona;1;Barcelona;21;Maresme;08126;Montgat;1;;8926;2129;4023;4786;4140;53;41;4692;4733
8;Barcelona;2;Catalunya Central;14;Berguedà;08132;Montmajor;1;;358;103;180;203;155;8;2;193;195
8;Barcelona;8;Penedès;6;Anoia;08133;Montmaneu;1;;129;39;74;86;43;0;0;86;86
43;Tarragona;8;Penedès;12;Baix Penedès;43090;Montmell, el;1;;1306;234;381;425;881;18;0;407;407
8;Barcelona;1;Barcelona;41;Vallès Oriental;08135;Montmeló;1;;6831;1953;3411;3947;2884;67;50;3830;3880
25;Lleida;4;Lleida;33;Segrià;25142;Montoliu de Lleida;1;;364;130;212;246;118;2;4;240;244
25;Lleida;4;Lleida;32;Segarra;25141;Montoliu de Segarra;1;;155;32;67;87;68;2;2;83;85
8;Barcelona;1;Barcelona;41;Vallès Oriental;08136;Montornès del Vallès;1;;9766;2117;4300;4898;4868;97;48;4753;4801
8;Barcelona;1;Barcelona;41;Vallès Oriental;08136;Montornès del Vallès;2;;2073;380;685;771;1302;10;5;756;761
25;Lleida;4;Lleida;32;Segarra;25143;Montornès de Segarra;1;;80;25;43;55;25;2;1;52;53
43;Tarragona;6;Camp de Tarragona;1;Alt Camp;43091;Mont-ral;1;;128;39;62;76;52;0;0;76;76
17;Girona;3;Girona;10;Baix Empordà;17110;Mont-ras;1;;1347;397;703;775;572;5;7;763;770
43;Tarragona;6;Camp de Tarragona;8;Baix Camp;43092;Mont-roig del Camp;1;;7648;1734;2956;3538;4110;52;17;3469;3486
8;Barcelona;1;Barcelona;41;Vallès Oriental;08137;Montseny;1;;285;89;151;197;88;5;0;192;192
43;Tarragona;7;Terres de l'Ebre;30;Ribera d'Ebre;43093;Móra d'Ebre;1;;2834;681;1158;1514;1320;39;13;1462;1475
43;Tarragona;7;Terres de l'Ebre;30;Ribera d'Ebre;43093;Móra d'Ebre;2;;999;223;401;484;515;5;3;476;479
43;Tarragona;7;Terres de l'Ebre;30;Ribera d'Ebre;43094;Móra la Nova;1;;1281;330;600;703;578;23;9;671;680
43;Tarragona;7;Terres de l'Ebre;30;Ribera d'Ebre;43094;Móra la Nova;2;;865;239;398;473;392;13;4;456;460
43;Tarragona;6;Camp de Tarragona;36;Tarragonès;43095;Morell, el;1;;2600;668;1265;1406;1194;25;10;1371;1381
43;Tarragona;6;Camp de Tarragona;29;Priorat;43096;Morera de Montsant, la;1;;102;39;58;72;30;2;0;70;70
8;Barcelona;2;Catalunya Central;24;Osona;08129;Muntanyola;1;;504;172;316;355;149;3;6;346;352
8;Barcelona;2;Catalunya Central;7;Bages;08139;Mura;1;;184;58;131;145;39;2;2;141;143
25;Lleida;4;Lleida;38;Urgell;25145;Nalec;1;;74;36;51;60;14;0;0;60;60
25;Lleida;5;Alt Pirineu i territori d'Aran;39;Consell General d'Aran;25025;Naut Aran;1;;1417;258;517;725;692;32;7;686;693
8;Barcelona;2;Catalunya Central;7;Bages;08140;Navarcles;1;;4832;1008;2243;2647;2185;36;25;2586;2611
8;Barcelona;2;Catalunya Central;7;Bages;08141;Navàs;1;;4303;1106;2210;2515;1788;20;30;2465;2495
8;Barcelona;2;Catalunya Central;7;Bages;08141;Navàs;2;;214;83;113;134;80;1;3;130;133
17;Girona;3;Girona;2;Alt Empordà;17111;Navata;1;;1007;301;559;651;356;11;5;635;640
25;Lleida;2;Catalunya Central;35;Solsonès;25146;Navès;1;;222;66;117;134;88;7;1;126;127
8;Barcelona;2;Catalunya Central;14;Berguedà;08142;Nou de Berguedà, la;1;;143;77;99;112;31;1;0;111;111
43;Tarragona;6;Camp de Tarragona;36;Tarragonès;43097;Nou de Gaià, la;1;;409;129;268;289;120;7;3;279;282
43;Tarragona;6;Camp de Tarragona;1;Alt Camp;43098;Nulles;1;;355;121;211;239;116;2;3;234;237
25;Lleida;2;Catalunya Central;35;Solsonès;25148;Odèn;1;;216;74;118;142;74;1;1;140;141
8;Barcelona;8;Penedès;6;Anoia;08143;Òdena;1;;2749;731;1321;1506;1243;33;25;1448;1473
17;Girona;3;Girona;31;Ripollès;17112;Ogassa;1;;194;69;109;133;61;2;0;131;131
8;Barcelona;8;Penedès;3;Alt Penedès;08145;Olèrdola;1;;2795;759;1539;1707;1088;32;20;1655;1675
8;Barcelona;8;Penedès;3;Alt Penedès;08146;Olesa de Bonesvalls;1;;1436;423;735;812;624;18;12;782;794
8;Barcelona;1;Barcelona;11;Baix Llobregat;08147;Olesa de Montserrat;1;;17547;3784;7841;9022;8525;154;111;8757;8868
25;Lleida;5;Alt Pirineu i territori d'Aran;4;Alt Urgell;25149;Oliana;1;;1373;421;701;830;543;11;3;816;819
25;Lleida;4;Lleida;23;Noguera;25150;Oliola;1;;166;39;101;118;48;4;1;113;114
25;Lleida;2;Catalunya Central;35;Solsonès;25151;Olius;1;;730;220;403;461;269;11;2;448;450
8;Barcelona;8;Penedès;17;Garraf;08148;Olivella;1;;2445;639;1089;1220;1225;21;7;1192;1199
8;Barcelona;2;Catalunya Central;24;Osona;08149;Olost;1;;968;246;491;570;398;12;6;552;558
17;Girona;3;Girona;19;Garrotxa;17114;Olot;1;;5496;1400;2577;2988;2508;34;23;2931;2954
17;Girona;3;Girona;19;Garrotxa;17114;Olot;2;;6364;1562;2885;3197;3167;52;43;3102;3145
17;Girona;3;Girona;19;Garrotxa;17114;Olot;3;;3562;885;1728;1983;1579;25;15;1943;1958
17;Girona;3;Girona;19;Garrotxa;17114;Olot;4;;2881;567;1056;1197;1684;22;12;1163;1175
17;Girona;3;Girona;19;Garrotxa;17114;Olot;5;;5000;1266;2654;3022;1978;40;27;2955;2982
25;Lleida;4;Lleida;32;Segarra;25152;Oluges, les;1;;148;38;77;92;56;0;2;90;92
8;Barcelona;2;Catalunya Central;14;Berguedà;08144;Olvan;1;;728;206;401;461;267;10;9;442;451
25;Lleida;4;Lleida;18;Garrigues;25153;Omellons, els;1;;181;44;89;103;78;5;6;92;98
25;Lleida;4;Lleida;38;Urgell;25154;Omells de na Gaia, els;1;;115;30;61;73;42;1;0;72;72
17;Girona;3;Girona;2;Alt Empordà;17115;Ordis;1;;278;122;171;200;78;7;4;189;193
25;Lleida;5;Alt Pirineu i territori d'Aran;4;Alt Urgell;25155;Organyà;1;;596;186;276;359;237;3;4;352;356
8;Barcelona;2;Catalunya Central;24;Osona;08150;Orís;1;;265;87;148;178;87;6;1;171;172
8;Barcelona;2;Catalunya Central;24;Osona;08151;Oristà;1;;449;174;281;300;149;5;2;293;295
8;Barcelona;8;Penedès;6;Anoia;08152;Orpí;1;;115;30;73;84;31;0;0;84;84
8;Barcelona;1;Barcelona;21;Maresme;08153;Òrrius;1;;593;209;360;420;173;4;3;413;416
25;Lleida;4;Lleida;23;Noguera;25156;Os de Balaguer;1;;783;231;421;493;290;2;9;482;491
17;Girona;3;Girona;34;Selva;17116;Osor;1;;349;128;210;226;123;4;3;219;222
25;Lleida;4;Lleida;38;Urgell;25157;Ossó de Sió;1;;159;43;92;105;54;0;5;100;105
8;Barcelona;8;Penedès;3;Alt Penedès;08154;Pacs del Penedès;1;;699;223;403;444;255;7;3;434;437
8;Barcelona;1;Barcelona;21;Maresme;08155;Palafolls;1;;7180;1706;3146;3698;3482;70;53;3575;3628
17;Girona;3;Girona;10;Baix Empordà;17117;Palafrugell;1;;6381;1270;2599;2967;3414;62;33;2872;2905
17;Girona;3;Girona;10;Baix Empordà;17117;Palafrugell;2;;4753;968;1982;2268;2485;27;16;2225;2241
17;Girona;3;Girona;10;Baix Empordà;17117;Palafrugell;3;;3455;745;1503;1696;1759;33;10;1653;1663
17;Girona;3;Girona;10;Baix Empordà;17118;Palamós;1;;4425;1114;1906;2300;2125;44;26;2230;2256
17;Girona;3;Girona;10;Baix Empordà;17118;Palamós;2;;2234;593;990;1196;1038;13;4;1179;1183
17;Girona;3;Girona;10;Baix Empordà;17118;Palamós;3;;4039;913;1657;1906;2133;41;17;1848;1865
17;Girona;3;Girona;10;Baix Empordà;17118;Palamós;4;;2428;475;916;1089;1339;23;10;1056;1066
25;Lleida;4;Lleida;27;Pla d'Urgell;25158;Palau d'Anglesola, el;1;;1613;354;867;998;615;11;21;966;987
17;Girona;3;Girona;2;Alt Empordà;17119;Palau de Santa Eulàlia;1;;82;33;49;63;19;0;5;58;63
17;Girona;3;Girona;10;Baix Empordà;17121;Palau-sator;1;;223;89;143;156;67;1;0;155;155
17;Girona;3;Girona;2;Alt Empordà;17120;Palau-saverdera;1;;836;230;437;481;355;14;3;464;467
8;Barcelona;1;Barcelona;40;Vallès Occidental;08156;Palau-solità i Plegamans;1;;11317;2633;5476;6222;5095;99;35;6088;6123
43;Tarragona;6;Camp de Tarragona;36;Tarragonès;43100;Pallaresos, els;1;;3597;696;1561;1960;1637;53;13;1894;1907
8;Barcelona;1;Barcelona;11;Baix Llobregat;08157;Pallejà;1;;8669;1931;4435;5052;3617;60;42;4950;4992
43;Tarragona;7;Terres de l'Ebre;30;Ribera d'Ebre;43099;Palma d'Ebre, la;1;;274;99;173;194;80;1;0;193;193
8;Barcelona;1;Barcelona;11;Baix Llobregat;08905;Palma de Cervelló, la;1;;2346;677;1297;1516;830;29;9;1478;1487
17;Girona;3;Girona;28;Pla de l'Estany;17123;Palol de Revardit;1;;335;121;244;254;81;15;0;239;239
17;Girona;3;Girona;10;Baix Empordà;17124;Pals;1;;1638;533;871;1007;631;20;7;980;987
8;Barcelona;1;Barcelona;11;Baix Llobregat;08158;Papiol, el;1;;3160;666;1567;1791;1369;18;25;1748;1773
17;Girona;3;Girona;31;Ripollès;17125;Pardines;1;;132;43;65;84;48;2;2;80;82
8;Barcelona;1;Barcelona;41;Vallès Oriental;08159;Parets del Vallès;1;;4873;1019;2134;2539;2334;38;15;2486;2501
8;Barcelona;1;Barcelona;41;Vallès Oriental;08159;Parets del Vallès;2;;9429;2209;4329;4991;4438;68;34;4889;4923
17;Girona;3;Girona;10;Baix Empordà;17126;Parlavà;1;;326;152;218;253;73;2;2;249;251
43;Tarragona;6;Camp de Tarragona;16;Conca de Barberà;43101;Passanant i Belltall;1;;143;61;84;93;50;2;3;88;91
17;Girona;3;Girona;2;Alt Empordà;17128;Pau;1;;335;130;196;226;109;7;1;218;219
43;Tarragona;7;Terres de l'Ebre;9;Baix Ebre;43102;Paüls;1;;448;135;211;255;193;4;5;246;251
17;Girona;3;Girona;2;Alt Empordà;17129;Pedret i Marzà;1;;138;47;79;97;41;2;1;94;95
25;Lleida;4;Lleida;23;Noguera;25164;Penelles;1;;355;119;194;214;141;5;0;209;209
17;Girona;3;Girona;10;Baix Empordà;17130;Pera, la;1;;333;88;222;248;85;2;6;240;246
8;Barcelona;2;Catalunya Central;24;Osona;08160;Perafita;1;;329;120;180;210;119;7;3;200;203
43;Tarragona;6;Camp de Tarragona;36;Tarragonès;43103;Perafort;1;;934;237;446;513;421;17;2;494;496
17;Girona;3;Girona;2;Alt Empordà;17132;Peralada;1;;1389;457;800;919;470;17;14;888;902
25;Lleida;5;Alt Pirineu i territori d'Aran;4;Alt Urgell;25165;Peramola;1;;273;97;161;183;90;5;4;174;178
43;Tarragona;7;Terres de l'Ebre;9;Baix Ebre;43104;Perelló, el;1;;1774;494;818;1058;716;31;12;1015;1027
8;Barcelona;8;Penedès;6;Anoia;08161;Piera;1;;12118;2297;4513;5209;6909;59;46;5104;5150
43;Tarragona;6;Camp de Tarragona;16;Conca de Barberà;43105;Piles, les;1;;160;40;96;116;44;4;7;105;112
8;Barcelona;1;Barcelona;21;Maresme;08163;Pineda de Mar;1;;19992;4199;8447;9561;10431;115;58;9388;9446
43;Tarragona;7;Terres de l'Ebre;37;Terra Alta;43106;Pinell de Brai, el;1;;784;241;392;446;338;7;0;439;439
25;Lleida;2;Catalunya Central;35;Solsonès;25166;Pinell de Solsonès;1;;167;46;80;91;76;1;2;88;90
25;Lleida;2;Catalunya Central;35;Solsonès;25167;Pinós;1;;231;64;131;152;79;3;6;143;149
43;Tarragona;6;Camp de Tarragona;16;Conca de Barberà;43107;Pira;1;;380;124;215;230;150;14;4;212;216
8;Barcelona;8;Penedès;3;Alt Penedès;08164;Pla del Penedès, el;1;;933;270;535;598;335;8;10;580;590
43;Tarragona;6;Camp de Tarragona;1;Alt Camp;43108;Pla de Santa Maria, el;1;;1803;480;877;967;836;17;1;949;950
17;Girona;3;Girona;19;Garrotxa;17133;Planes d'Hostoles, les;1;;1272;484;755;870;402;9;9;852;861
17;Girona;3;Girona;31;Ripollès;17134;Planoles;1;;227;66;118;147;80;7;4;136;140
25;Lleida;4;Lleida;32;Segarra;25911;Plans de Sió, els;1;;419;127;220;270;149;5;12;253;265
25;Lleida;4;Lleida;27;Pla d'Urgell;25168;Poal, el;1;;497;197;299;326;171;9;9;308;317
25;Lleida;4;Lleida;18;Garrigues;25169;Pobla de Cérvoles, la;1;;175;54;90;112;63;6;8;98;106
8;Barcelona;8;Penedès;6;Anoia;08165;Pobla de Claramunt, la;1;;1654;380;732;914;740;10;8;896;904
8;Barcelona;2;Catalunya Central;14;Berguedà;08166;Pobla de Lillet, la;1;;933;273;486;547;386;5;4;538;542
43;Tarragona;6;Camp de Tarragona;36;Tarragonès;43109;Pobla de Mafumet, la;1;;2757;556;1025;1186;1571;18;26;1142;1168
43;Tarragona;7;Terres de l'Ebre;37;Terra Alta;43110;Pobla de Massaluca, la;1;;251;70;130;148;103;1;2;145;147
43;Tarragona;6;Camp de Tarragona;36;Tarragonès;43111;Pobla de Montornès, la;1;;2217;491;859;974;1243;18;8;948;956
25;Lleida;5;Alt Pirineu i territori d'Aran;25;Pallars Jussà;25171;Pobla de Segur, la;1;;2157;528;981;1324;833;28;14;1282;1296
43;Tarragona;6;Camp de Tarragona;29;Priorat;43112;Poboleda;1;;258;100;154;176;82;2;2;172;174
8;Barcelona;1;Barcelona;40;Vallès Occidental;08167;Polinyà;1;;6121;1292;2623;2976;3145;51;37;2888;2925
43;Tarragona;6;Camp de Tarragona;1;Alt Camp;43113;Pont d'Armentera, el;1;;390;139;213;235;155;5;1;229;230
25;Lleida;5;Alt Pirineu i territori d'Aran;4;Alt Urgell;25030;Pont de Bar, el;1;;133;37;65;75;58;1;1;73;74
17;Girona;3;Girona;2;Alt Empordà;17135;Pont de Molins;1;;398;103;216;243;155;6;3;234;237
25;Lleida;5;Alt Pirineu i territori d'Aran;5;Alta Ribagorça;25173;Pont de Suert, el;1;;1667;378;659;930;737;18;11;901;912
8;Barcelona;2;Catalunya Central;7;Bages;08182;Pont de Vilomara i Rocafort, el;1;;2994;640;1216;1379;1615;13;15;1351;1366
43;Tarragona;6;Camp de Tarragona;16;Conca de Barberà;43141;Pontils;1;;113;36;66;72;41;4;1;67;68
8;Barcelona;8;Penedès;3;Alt Penedès;08168;Pontons;1;;382;114;171;209;173;4;2;203;205
17;Girona;3;Girona;2;Alt Empordà;17136;Pontós;1;;190;74;116;140;50;2;0;138;138
25;Lleida;4;Lleida;23;Noguera;25172;Ponts;1;;1749;467;846;1033;716;16;8;1009;1017
17;Girona;3;Girona;28;Pla de l'Estany;17137;Porqueres;1;;3547;1056;2228;2419;1128;41;23;2355;2378
43;Tarragona;6;Camp de Tarragona;29;Priorat;43114;Porrera;1;;372;120;217;269;103;2;1;266;267
17;Girona;3;Girona;2;Alt Empordà;17138;Portbou;1;;833;289;449;530;303;15;8;507;515
17;Girona;3;Girona;2;Alt Empordà;17140;Port de la Selva, el;1;;667;271;397;469;198;17;3;449;452
25;Lleida;4;Lleida;33;Segrià;25174;Portella, la;1;;384;147;226;261;123;1;3;257;260
43;Tarragona;6;Camp de Tarragona;29;Priorat;43115;Pradell de la Teixeta;1;;134;55;90;97;37;5;1;91;92
43;Tarragona;6;Camp de Tarragona;8;Baix Camp;43116;Prades;1;;467;170;280;319;148;4;2;313;315
43;Tarragona;7;Terres de l'Ebre;37;Terra Alta;43117;Prat de Comte;1;;147;40;73;99;48;1;1;97;98
8;Barcelona;1;Barcelona;11;Baix Llobregat;08169;Prat de Llobregat, el;1;;6469;1181;2956;3455;3014;44;18;3393;3411
8;Barcelona;1;Barcelona;11;Baix Llobregat;08169;Prat de Llobregat, el;2;;9795;1854;4359;5043;4752;64;47;4932;4979
8;Barcelona;1;Barcelona;11;Baix Llobregat;08169;Prat de Llobregat, el;3;;14991;3437;6558;7373;7618;80;84;7209;7293
8;Barcelona;1;Barcelona;11;Baix Llobregat;08169;Prat de Llobregat, el;4;;5888;988;1669;1864;4024;22;17;1825;1842
8;Barcelona;1;Barcelona;11;Baix Llobregat;08169;Prat de Llobregat, el;5;;11514;2194;4934;5666;5848;72;61;5533;5594
43;Tarragona;6;Camp de Tarragona;8;Baix Camp;43118;Pratdip;1;;426;146;252;283;143;2;3;278;281
8;Barcelona;2;Catalunya Central;24;Osona;08171;Prats de Lluçanès;1;;2070;564;1090;1251;819;27;13;1211;1224
8;Barcelona;2;Catalunya Central;6;Anoia;08170;Prats de Rei, els;1;;443;138;244;269;174;10;3;256;259
25;Lleida;5;Alt Pirineu i territori d'Aran;15;Cerdanya;25175;Prats i Sansor;1;;197;57;102;138;59;5;3;130;133
25;Lleida;4;Lleida;38;Urgell;25176;Preixana;1;;323;118;178;212;111;4;4;204;208
25;Lleida;4;Lleida;23;Noguera;25177;Preixens;1;;350;113;185;212;138;3;1;208;209
8;Barcelona;1;Barcelona;21;Maresme;08230;Premià de Dalt;1;;7707;1970;3768;4615;3092;51;37;4527;4564
8;Barcelona;1;Barcelona;21;Maresme;08172;Premià de Mar;1;;5451;1132;2540;3190;2261;21;30;3139;3169
8;Barcelona;1;Barcelona;21;Maresme;08172;Premià de Mar;2;;5430;1160;2241;2716;2714;30;21;2665;2686
8;Barcelona;1;Barcelona;21;Maresme;08172;Premià de Mar;3;;9635;2090;4328;5224;4411;48;39;5137;5176
17;Girona;3;Girona;19;Garrotxa;17139;Preses, les;1;;1431;436;819;935;496;25;6;904;910
25;Lleida;5;Alt Pirineu i territori d'Aran;15;Cerdanya;25179;Prullans;1;;184;58;104;124;60;4;1;119;120
17;Girona;5;Alt Pirineu i territori d'Aran;15;Cerdanya;17141;Puigcerdà;1;;6180;941;2050;2847;3333;61;28;2758;2786
8;Barcelona;8;Penedès;3;Alt Penedès;08174;Puigdàlber;1;;403;125;235;278;125;3;3;272;275
25;Lleida;4;Lleida;18;Garrigues;25180;Puiggròs;1;;218;76;118;140;78;6;2;132;134
43;Tarragona;6;Camp de Tarragona;1;Alt Camp;43119;Puigpelat;1;;877;209;410;456;421;12;5;439;444
8;Barcelona;2;Catalunya Central;14;Berguedà;08175;Puig-reig;1;;2869;668;1325;1561;1308;30;25;1506;1531
8;Barcelona;2;Catalunya Central;14;Berguedà;08175;Puig-reig;2;;487;181;290;322;165;3;3;316;319
25;Lleida;4;Lleida;38;Urgell;25181;Puigverd d'Agramunt;1;;154;47;77;97;57;3;3;91;94
25;Lleida;4;Lleida;33;Segrià;25182;Puigverd de Lleida;1;;1059;281;520;618;441;11;9;598;607
8;Barcelona;2;Catalunya Central;6;Anoia;08176;Pujalt;1;;156;52;96;102;54;5;2;95;97
8;Barcelona;2;Catalunya Central;14;Berguedà;08177;Quar, la;1;;35;10;15;20;15;0;0;20;20
17;Girona;3;Girona;20;Gironès;17142;Quart;1;;2734;801;1542;1816;918;23;30;1763;1793
17;Girona;3;Girona;31;Ripollès;17043;Queralbs;1;;160;58;102;126;34;4;0;122;122
43;Tarragona;6;Camp de Tarragona;1;Alt Camp;43120;Querol;1;;426;104;171;215;211;12;0;203;203
17;Girona;3;Girona;2;Alt Empordà;17143;Rabós;1;;148;54;87;93;55;0;1;92;93
8;Barcelona;2;Catalunya Central;7;Bages;08178;Rajadell;1;;441;148;271;313;128;3;5;305;310
43;Tarragona;7;Terres de l'Ebre;30;Ribera d'Ebre;43121;Rasquera;1;;602;186;332;347;255;5;3;339;342
17;Girona;3;Girona;10;Baix Empordà;17144;Regencós;1;;220;90;136;150;70;2;3;145;148
8;Barcelona;1;Barcelona;40;Vallès Occidental;08179;Rellinars;1;;666;168;343;377;289;8;4;365;369
43;Tarragona;6;Camp de Tarragona;36;Tarragonès;43122;Renau;1;;114;33;67;78;36;3;1;74;75
43;Tarragona;6;Camp de Tarragona;8;Baix Camp;43123;Reus;1;;3167;671;1380;1648;1519;20;7;1621;1628
43;Tarragona;6;Camp de Tarragona;8;Baix Camp;43123;Reus;10;;1673;298;706;849;824;19;7;823;830
43;Tarragona;6;Camp de Tarragona;8;Baix Camp;43123;Reus;2;;13346;2800;5429;6446;6900;100;44;6302;6346
43;Tarragona;6;Camp de Tarragona;8;Baix Camp;43123;Reus;3;;11024;1624;3713;4483;6541;87;37;4359;4396
43;Tarragona;6;Camp de Tarragona;8;Baix Camp;43123;Reus;4;;6091;1012;2118;2509;3582;46;16;2447;2463
43;Tarragona;6;Camp de Tarragona;8;Baix Camp;43123;Reus;5;;6614;1142;2391;2869;3745;53;34;2782;2816
43;Tarragona;6;Camp de Tarragona;8;Baix Camp;43123;Reus;6;;13763;2893;6400;7782;5981;125;64;7593;7657
43;Tarragona;6;Camp de Tarragona;8;Baix Camp;43123;Reus;7;;5768;918;1704;2062;3706;48;16;1998;2014
43;Tarragona;6;Camp de Tarragona;8;Baix Camp;43123;Reus;8;;8466;1197;3331;3913;4553;74;31;3808;3839
43;Tarragona;6;Camp de Tarragona;8;Baix Camp;43123;Reus;9;;1818;359;766;938;880;9;4;925;929
25;Lleida;5;Alt Pirineu i territori d'Aran;26;Pallars Sobirà;25183;Rialp;1;;522;100;274;339;183;16;4;319;323
43;Tarragona;6;Camp de Tarragona;1;Alt Camp;43124;Riba, la;1;;461;148;220;264;197;5;3;256;259
43;Tarragona;7;Terres de l'Ebre;30;Ribera d'Ebre;43125;Riba-roja d'Ebre;1;;876;229;394;532;344;22;8;502;510
25;Lleida;4;Lleida;32;Segarra;25905;Ribera d'Ondara;1;;369;105;213;231;138;16;3;212;215
25;Lleida;5;Alt Pirineu i territori d'Aran;4;Alt Urgell;25185;Ribera d'Urgellet;1;;674;172;322;377;297;13;4;360;364
17;Girona;3;Girona;31;Ripollès;17145;Ribes de Freser;1;;1442;368;678;846;596;12;10;824;834
17;Girona;3;Girona;34;Selva;17146;Riells i Viabrea;1;;3230;879;1408;1637;1593;18;22;1597;1619
43;Tarragona;6;Camp de Tarragona;36;Tarragonès;43126;Riera de Gaià, la;1;;1222;342;634;729;493;15;2;712;714
25;Lleida;2;Catalunya Central;35;Solsonès;25186;Riner;1;;214;73;134;155;59;3;1;151;152
17;Girona;3;Girona;31;Ripollès;17147;Ripoll;1;;1075;225;438;507;568;10;6;491;497
17;Girona;3;Girona;31;Ripollès;17147;Ripoll;2;;1190;290;507;610;580;11;4;595;599
17;Girona;3;Girona;31;Ripollès;17147;Ripoll;3;;4661;1071;1973;2398;2263;50;15;2333;2348
17;Girona;3;Girona;31;Ripollès;17147;Ripoll;4;;978;257;476;560;418;11;2;547;549
8;Barcelona;1;Barcelona;40;Vallès Occidental;08180;Ripollet;1;;18912;3835;8136;9441;9471;106;73;9262;9335
8;Barcelona;1;Barcelona;40;Vallès Occidental;08180;Ripollet;2;;8455;1431;3075;3550;4905;71;27;3452;3479
17;Girona;3;Girona;34;Selva;17148;Riudarenes;1;;1595;421;749;871;724;12;18;841;859
17;Girona;3;Girona;19;Garrotxa;17149;Riudaura;1;;379;112;246;285;94;3;1;281;282
43;Tarragona;6;Camp de Tarragona;8;Baix Camp;43127;Riudecanyes;1;;823;263;453;516;307;12;0;504;504
25;Lleida;5;Alt Pirineu i territori d'Aran;15;Cerdanya;25913;Riu de Cerdanya;1;;88;29;57;72;16;0;0;72;72
43;Tarragona;6;Camp de Tarragona;8;Baix Camp;43128;Riudecols;1;;915;247;452;501;414;17;5;479;484
17;Girona;3;Girona;34;Selva;17150;Riudellots de la Selva;1;;1450;523;906;1026;424;30;10;986;996
43;Tarragona;6;Camp de Tarragona;8;Baix Camp;43129;Riudoms;1;;924;202;408;488;436;26;4;458;462
43;Tarragona;6;Camp de Tarragona;8;Baix Camp;43129;Riudoms;2;;3752;850;1700;2067;1685;42;12;2013;2025
17;Girona;3;Girona;2;Alt Empordà;17151;Riumors;1;;176;41;91;111;65;3;2;106;108
8;Barcelona;1;Barcelona;41;Vallès Oriental;08181;Roca del Vallès, la;1;;8173;1897;4090;4750;3423;69;39;4642;4681
43;Tarragona;6;Camp de Tarragona;16;Conca de Barberà;43130;Rocafort de Queralt;1;;177;77;110;123;54;3;0;120;120
43;Tarragona;6;Camp de Tarragona;36;Tarragonès;43131;Roda de Berà;1;;5099;1027;1821;2210;2889;51;9;2150;2159
8;Barcelona;2;Catalunya Central;24;Osona;08183;Roda de Ter;1;;3728;994;1907;2145;1583;33;20;2092;2112
8;Barcelona;2;Catalunya Central;24;Osona;08183;Roda de Ter;2;;858;246;395;472;386;0;11;461;472
43;Tarragona;6;Camp de Tarragona;1;Alt Camp;43132;Rodonyà;1;;386;118;235;245;141;4;7;234;241
43;Tarragona;7;Terres de l'Ebre;9;Baix Ebre;43133;Roquetes;1;;2191;447;771;986;1205;24;11;951;962
43;Tarragona;7;Terres de l'Ebre;9;Baix Ebre;43133;Roquetes;2;;3459;756;1326;1594;1865;46;12;1536;1548
17;Girona;3;Girona;2;Alt Empordà;17152;Roses;1;;6480;1187;2583;2964;3516;56;29;2879;2908
17;Girona;3;Girona;2;Alt Empordà;17152;Roses;2;;4719;1015;2117;2389;2330;57;30;2302;2332
25;Lleida;4;Lleida;33;Segrià;25189;Rosselló;1;;2228;525;983;1146;1082;35;7;1104;1111
43;Tarragona;6;Camp de Tarragona;1;Alt Camp;43134;Rourell, el;1;;293;101;161;179;114;5;4;170;174
8;Barcelona;1;Barcelona;40;Vallès Occidental;08184;Rubí;1;;5075;1178;2320;2562;2513;46;21;2495;2516
8;Barcelona;1;Barcelona;40;Vallès Occidental;08184;Rubí;2;;8312;1510;3264;3798;4514;56;34;3708;3742
8;Barcelona;1;Barcelona;40;Vallès Occidental;08184;Rubí;3;;10786;1720;4342;4921;5865;52;36;4833;4869
8;Barcelona;1;Barcelona;40;Vallès Occidental;08184;Rubí;4;;31130;5346;12303;14252;16878;191;121;13940;14061
8;Barcelona;8;Penedès;6;Anoia;08185;Rubió;1;;197;65;100;120;77;2;1;117;118
17;Girona;3;Girona;10;Baix Empordà;17153;Rupià;1;;200;65;138;153;47;3;1;149;150
8;Barcelona;2;Catalunya Central;24;Osona;08901;Rupit i Pruit;1;;245;119;164;189;56;6;7;176;183
8;Barcelona;1;Barcelona;40;Vallès Occidental;08187;Sabadell;1;;41439;10866;22854;26695;14744;290;183;26222;26405
8;Barcelona;1;Barcelona;40;Vallès Occidental;08187;Sabadell;2;;17714;4030;8516;10090;7624;115;69;9906;9975
8;Barcelona;1;Barcelona;40;Vallès Occidental;08187;Sabadell;3;;24365;5393;9521;10833;13532;142;102;10589;10691
8;Barcelona;1;Barcelona;40;Vallès Occidental;08187;Sabadell;4;;29978;6972;13685;15197;14781;207;125;14865;14990
8;Barcelona;1;Barcelona;40;Vallès Occidental;08187;Sabadell;5;;14426;3143;6671;7775;6651;95;70;7610;7680
8;Barcelona;1;Barcelona;40;Vallès Occidental;08187;Sabadell;6;;20040;3964;7207;8279;11761;118;64;8097;8161
8;Barcelona;1;Barcelona;40;Vallès Occidental;08187;Sabadell;7;;5991;1109;2004;2231;3760;26;26;2179;2205
8;Barcelona;2;Catalunya Central;14;Berguedà;08188;Sagàs;1;;117;47;78;89;28;1;2;86;88
25;Lleida;5;Alt Pirineu i territori d'Aran;25;Pallars Jussà;25190;Salàs de Pallars;1;;265;89;140;173;92;4;0;169;169
8;Barcelona;2;Catalunya Central;14;Berguedà;08190;Saldes;1;;260;107;159;178;82;6;2;170;172
17;Girona;3;Girona;19;Garrotxa;17154;Sales de Llierca;1;;107;35;54;68;39;2;1;65;66
8;Barcelona;2;Catalunya Central;7;Bages;08191;Sallent;1;;4818;1199;2229;2634;2184;22;38;2574;2612
8;Barcelona;2;Catalunya Central;7;Bages;08191;Sallent;2;;427;130;244;264;163;4;5;255;260
43;Tarragona;6;Camp de Tarragona;36;Tarragonès;43135;Salomó;1;;333;104;195;224;109;3;3;218;221
43;Tarragona;6;Camp de Tarragona;36;Tarragonès;43905;Salou;1;;15413;2747;5939;7077;8336;107;63;6907;6970
17;Girona;3;Girona;20;Gironès;17155;Salt;1;;8202;2002;3454;3840;4362;51;29;3760;3789
17;Girona;3;Girona;20;Gironès;17155;Salt;2;;6865;1443;2744;3145;3720;51;28;3066;3094
25;Lleida;4;Lleida;32;Segarra;25191;Sanaüja;1;;335;71;168;198;137;11;3;184;187
43;Tarragona;7;Terres de l'Ebre;22;Montsià;43138;Santa Bàrbara;1;;1397;310;496;644;753;25;5;614;619
43;Tarragona;7;Terres de l'Ebre;22;Montsià;43138;Santa Bàrbara;2;;1247;221;403;529;718;23;6;500;506
8;Barcelona;2;Catalunya Central;24;Osona;08243;Santa Cecília de Voltregà;1;;152;39;100;109;43;3;2;104;106
8;Barcelona;1;Barcelona;11;Baix Llobregat;08244;Santa Coloma de Cervelló;1;;6207;1672;3157;3789;2418;56;37;3696;3733
17;Girona;3;Girona;34;Selva;17180;Santa Coloma de Farners;1;;8588;1948;3773;4510;4078;75;43;4392;4435
8;Barcelona;1;Barcelona;13;Barcelonès;08245;Santa Coloma de Gramenet;1;;15069;2725;6305;7312;7757;99;43;7170;7213
8;Barcelona;1;Barcelona;13;Barcelonès;08245;Santa Coloma de Gramenet;2;;10367;2239;4251;4762;5605;72;43;4647;4690
8;Barcelona;1;Barcelona;13;Barcelonès;08245;Santa Coloma de Gramenet;3;;14235;2906;5743;6486;7749;79;64;6343;6407
8;Barcelona;1;Barcelona;13;Barcelonès;08245;Santa Coloma de Gramenet;4;;15848;3016;6426;7510;8338;114;59;7337;7396
8;Barcelona;1;Barcelona;13;Barcelonès;08245;Santa Coloma de Gramenet;5;;13627;2418;4601;5188;8439;78;34;5076;5110
8;Barcelona;1;Barcelona;13;Barcelonès;08245;Santa Coloma de Gramenet;6;;7601;1426;2515;2833;4768;50;16;2767;2783
43;Tarragona;6;Camp de Tarragona;16;Conca de Barberà;43139;Santa Coloma de Queralt;1;;1199;237;565;683;516;16;7;660;667
43;Tarragona;6;Camp de Tarragona;16;Conca de Barberà;43139;Santa Coloma de Queralt;2;;814;157;397;478;336;10;2;466;468
17;Girona;3;Girona;10;Baix Empordà;17181;Santa Cristina d'Aro;1;;3578;773;1598;1899;1679;31;18;1850;1868
8;Barcelona;1;Barcelona;13;Barcelonès;08194;Sant Adrià de Besòs;1;;7451;1214;3069;3672;3779;58;22;3592;3614
8;Barcelona;1;Barcelona;13;Barcelonès;08194;Sant Adrià de Besòs;2;;6498;1126;2386;2836;3662;26;32;2778;2810
8;Barcelona;1;Barcelona;13;Barcelonès;08194;Sant Adrià de Besòs;3;;394;49;101;117;277;1;1;115;116
8;Barcelona;1;Barcelona;13;Barcelonès;08194;Sant Adrià de Besòs;4;;966;169;396;493;473;7;0;486;486
8;Barcelona;1;Barcelona;13;Barcelonès;08194;Sant Adrià de Besòs;5;;3816;855;1520;1713;2103;20;9;1684;1693
8;Barcelona;1;Barcelona;13;Barcelonès;08194;Sant Adrià de Besòs;6;;6469;833;1349;1528;4941;18;13;1497;1510
8;Barcelona;2;Catalunya Central;24;Osona;08246;Santa Eugènia de Berga;1;;1693;533;991;1093;600;11;4;1078;1082
8;Barcelona;2;Catalunya Central;24;Osona;08247;Santa Eulàlia de Riuprimer;1;;1013;305;641;720;293;21;7;692;699
8;Barcelona;1;Barcelona;41;Vallès Oriental;08248;Santa Eulàlia de Ronçana;1;;5805;1267;2671;3055;2750;34;31;2990;3021
8;Barcelona;8;Penedès;3;Alt Penedès;08249;Santa Fe del Penedès;1;;282;108;204;230;52;5;7;218;225
8;Barcelona;2;Catalunya Central;24;Osona;08195;Sant Agustí de Lluçanès;1;;80;24;49;57;23;6;1;50;51
17;Girona;3;Girona;2;Alt Empordà;17182;Santa Llogaia d'Àlguema;1;;285;88;142;151;134;5;1;145;146
8;Barcelona;8;Penedès;6;Anoia;08250;Santa Margarida de Montbui;1;;7194;1514;2641;3141;4053;58;37;3046;3083
8;Barcelona;8;Penedès;3;Alt Penedès;08251;Santa Margarida i els Monjos;1;;5181;1252;2245;2618;2563;36;26;2556;2582
8;Barcelona;2;Catalunya Central;42;Moianès;08258;Santa Maria d'Oló;1;;839;250;534;588;251;8;7;573;580
8;Barcelona;2;Catalunya Central;24;Osona;08253;Santa Maria de Besora;1;;132;53;86;92;40;2;3;87;90
8;Barcelona;1;Barcelona;41;Vallès Oriental;08256;Santa Maria de Martorelles;1;;692;172;365;425;267;5;9;411;420
8;Barcelona;2;Catalunya Central;14;Berguedà;08255;Santa Maria de Merlès;1;;124;44;77;89;35;0;2;87;89
8;Barcelona;8;Penedès;6;Anoia;08257;Santa Maria de Miralles;1;;106;45;67;76;30;1;2;73;75
8;Barcelona;1;Barcelona;41;Vallès Oriental;08259;Santa Maria de Palautordera;1;;7108;1991;3830;4371;2737;49;39;4283;4322
8;Barcelona;1;Barcelona;11;Baix Llobregat;08196;Sant Andreu de la Barca;1;;19510;4137;8553;9698;9812;132;86;9480;9566
8;Barcelona;1;Barcelona;21;Maresme;08197;Sant Andreu de Llavaneres;1;;4560;943;2120;2564;1996;29;28;2507;2535
8;Barcelona;1;Barcelona;21;Maresme;08197;Sant Andreu de Llavaneres;2;;3522;788;1705;2038;1484;21;13;2004;2017
17;Girona;3;Girona;20;Gironès;17157;Sant Andreu Salou;1;;119;35;86;97;22;1;2;94;96
17;Girona;3;Girona;19;Garrotxa;17183;Sant Aniol de Finestres;1;;255;95;152;172;83;4;4;164;168
8;Barcelona;1;Barcelona;41;Vallès Oriental;08198;Sant Antoni de Vilamajor;1;;4753;988;2241;2768;1985;44;22;2702;2724
43;Tarragona;8;Penedès;12;Baix Penedès;43140;Santa Oliva;1;;2486;622;1061;1153;1333;19;11;1123;1134
17;Girona;3;Girona;19;Garrotxa;17184;Santa Pau;1;;1254;419;719;830;424;19;11;800;811
8;Barcelona;1;Barcelona;40;Vallès Occidental;08260;Santa Perpètua de Mogoda;1;;18704;4028;8331;9461;9243;159;59;9243;9302
8;Barcelona;1;Barcelona;21;Maresme;08261;Santa Susanna;1;;2447;572;1139;1388;1059;13;22;1353;1375
8;Barcelona;2;Catalunya Central;24;Osona;08199;Sant Bartomeu del Grau;1;;655;198;379;418;237;10;4;404;408
8;Barcelona;1;Barcelona;11;Baix Llobregat;08200;Sant Boi de Llobregat;1;;7263;1494;2841;3140;4123;51;21;3068;3089
8;Barcelona;1;Barcelona;11;Baix Llobregat;08200;Sant Boi de Llobregat;2;;24405;5362;11034;12281;12124;165;135;11981;12116
8;Barcelona;1;Barcelona;11;Baix Llobregat;08200;Sant Boi de Llobregat;3;;10783;2499;4937;5758;5025;56;49;5653;5702
8;Barcelona;1;Barcelona;11;Baix Llobregat;08200;Sant Boi de Llobregat;4;;11901;2627;5235;5846;6055;60;79;5707;5786
8;Barcelona;1;Barcelona;11;Baix Llobregat;08200;Sant Boi de Llobregat;5;;3768;633;1199;1367;2401;18;20;1329;1349
8;Barcelona;1;Barcelona;11;Baix Llobregat;08200;Sant Boi de Llobregat;6;;3987;838;1602;1766;2221;30;29;1707;1736
8;Barcelona;2;Catalunya Central;24;Osona;08201;Sant Boi de Lluçanès;1;;465;143;239;303;162;13;6;284;290
43;Tarragona;7;Terres de l'Ebre;22;Montsià;43136;Sant Carles de la Ràpita;1;;6506;1451;2604;2960;3546;44;30;2886;2916
43;Tarragona;7;Terres de l'Ebre;22;Montsià;43136;Sant Carles de la Ràpita;2;;4088;1013;1796;2034;2054;44;10;1980;1990
8;Barcelona;1;Barcelona;21;Maresme;08203;Sant Cebrià de Vallalta;1;;2523;614;1120;1285;1238;9;12;1264;1276
8;Barcelona;1;Barcelona;41;Vallès Oriental;08202;Sant Celoni;1;;11391;2943;5442;6189;5202;77;43;6069;6112
8;Barcelona;1;Barcelona;41;Vallès Oriental;08202;Sant Celoni;2;;1667;400;736;823;844;10;6;807;813
8;Barcelona;1;Barcelona;11;Baix Llobregat;08204;Sant Climent de Llobregat;1;;3173;728;1642;1858;1315;33;13;1812;1825
17;Girona;3;Girona;2;Alt Empordà;17158;Sant Climent Sescebes;1;;533;141;206;246;287;4;0;242;242
8;Barcelona;1;Barcelona;40;Vallès Occidental;08205;Sant Cugat del Vallès;1;;27946;6648;15790;18549;9397;187;145;18217;18362
8;Barcelona;1;Barcelona;40;Vallès Occidental;08205;Sant Cugat del Vallès;2;;14352;3615;8545;10036;4316;105;91;9840;9931
8;Barcelona;1;Barcelona;40;Vallès Occidental;08205;Sant Cugat del Vallès;3;;5911;1327;3337;3904;2007;35;26;3843;3869
8;Barcelona;1;Barcelona;40;Vallès Occidental;08205;Sant Cugat del Vallès;4;;3243;941;1859;2105;1138;15;19;2071;2090
8;Barcelona;1;Barcelona;40;Vallès Occidental;08205;Sant Cugat del Vallès;5;;10866;2398;6160;7415;3451;62;64;7289;7353
8;Barcelona;1;Barcelona;40;Vallès Occidental;08205;Sant Cugat del Vallès;6;;952;207;430;480;472;14;4;462;466
8;Barcelona;8;Penedès;3;Alt Penedès;08206;Sant Cugat Sesgarrigues;1;;741;201;463;530;211;7;4;519;523
25;Lleida;5;Alt Pirineu i territori d'Aran;25;Pallars Jussà;25196;Sant Esteve de la Sarga;1;;105;23;42;67;38;1;1;65;66
8;Barcelona;1;Barcelona;41;Vallès Oriental;08207;Sant Esteve de Palautordera;1;;2126;438;1268;1467;659;20;20;1427;1447
8;Barcelona;1;Barcelona;11;Baix Llobregat;08208;Sant Esteve Sesrovires;1;;5870;1388;2792;3336;2534;35;31;3270;3301
17;Girona;3;Girona;34;Selva;17159;Sant Feliu de Buixalleu;1;;637;151;338;385;252;5;6;374;380
8;Barcelona;1;Barcelona;41;Vallès Oriental;08210;Sant Feliu de Codines;1;;2712;464;1164;1388;1324;18;8;1362;1370
8;Barcelona;1;Barcelona;41;Vallès Oriental;08210;Sant Feliu de Codines;2;;2014;391;853;1014;1000;19;11;984;995
17;Girona;3;Girona;10;Baix Empordà;17160;Sant Feliu de Guíxols;1;;2492;645;1241;1443;1049;29;15;1399;1414
17;Girona;3;Girona;10;Baix Empordà;17160;Sant Feliu de Guíxols;2;;6622;1512;2655;2920;3702;38;31;2851;2882
17;Girona;3;Girona;10;Baix Empordà;17160;Sant Feliu de Guíxols;3;;3701;977;1619;1845;1856;31;17;1797;1814
17;Girona;3;Girona;10;Baix Empordà;17160;Sant Feliu de Guíxols;4;;2036;408;911;1118;918;10;8;1100;1108
8;Barcelona;1;Barcelona;11;Baix Llobregat;08211;Sant Feliu de Llobregat;1;;8824;2557;5053;5803;3021;61;44;5698;5742
8;Barcelona;1;Barcelona;11;Baix Llobregat;08211;Sant Feliu de Llobregat;2;;5318;1352;2485;2799;2519;39;28;2732;2760
8;Barcelona;1;Barcelona;11;Baix Llobregat;08211;Sant Feliu de Llobregat;3;;7056;1856;3463;4048;3008;64;17;3967;3984
8;Barcelona;1;Barcelona;11;Baix Llobregat;08211;Sant Feliu de Llobregat;4;;3361;859;1379;1552;1809;20;11;1521;1532
8;Barcelona;1;Barcelona;11;Baix Llobregat;08211;Sant Feliu de Llobregat;5;;4469;1084;1886;2117;2352;38;20;2059;2079
8;Barcelona;1;Barcelona;11;Baix Llobregat;08211;Sant Feliu de Llobregat;6;;1048;252;555;635;413;10;6;619;625
8;Barcelona;1;Barcelona;11;Baix Llobregat;08211;Sant Feliu de Llobregat;7;;4038;1121;2353;2728;1310;45;24;2659;2683
17;Girona;3;Girona;19;Garrotxa;17161;Sant Feliu de Pallerols;1;;1038;330;663;741;297;13;3;725;728
8;Barcelona;2;Catalunya Central;7;Bages;08212;Sant Feliu Sasserra;1;;481;190;300;343;138;9;3;331;334
17;Girona;3;Girona;19;Garrotxa;17162;Sant Ferriol;1;;160;47;74;91;69;0;1;90;91
8;Barcelona;1;Barcelona;41;Vallès Oriental;08209;Sant Fost de Campsentelles;1;;7033;1353;2895;3565;3468;39;34;3492;3526
8;Barcelona;2;Catalunya Central;7;Bages;08213;Sant Fruitós de Bages;1;;6686;1608;3191;3751;2935;43;37;3671;3708
17;Girona;3;Girona;20;Gironès;17163;Sant Gregori;1;;2941;861;1760;2030;911;45;9;1976;1985
25;Lleida;4;Lleida;32;Segarra;25192;Sant Guim de Freixenet;1;;741;161;366;436;305;10;1;425;426
25;Lleida;4;Lleida;32;Segarra;25197;Sant Guim de la Plana;1;;140;67;97;106;34;2;2;102;104
17;Girona;3;Girona;34;Selva;17164;Sant Hilari Sacalm;1;;3890;954;1759;2096;1794;56;14;2026;2040
8;Barcelona;2;Catalunya Central;24;Osona;08215;Sant Hipòlit de Voltregà;1;;2618;756;1389;1545;1073;31;17;1497;1514
8;Barcelona;1;Barcelona;21;Maresme;08193;Sant Iscle de Vallalta;1;;1022;242;493;570;452;14;5;551;556
43;Tarragona;7;Terres de l'Ebre;22;Montsià;43902;Sant Jaume d'Enveja;1;;2769;761;1140;1294;1475;161;16;1117;1133
8;Barcelona;2;Catalunya Central;14;Berguedà;08216;Sant Jaume de Frontanyà;1;;23;7;9;12;11;0;0;12;12
17;Girona;3;Girona;19;Garrotxa;17165;Sant Jaume de Llierca;1;;627;194;338;377;250;5;4;368;372
43;Tarragona;8;Penedès;12;Baix Penedès;43137;Sant Jaume dels Domenys;1;;1930;464;840;1003;927;23;5;975;980
17;Girona;3;Girona;31;Ripollès;17167;Sant Joan de les Abadesses;1;;2603;756;1372;1627;976;33;24;1570;1594
17;Girona;3;Girona;20;Gironès;17168;Sant Joan de Mollet;1;;372;132;244;267;105;6;7;254;261
8;Barcelona;1;Barcelona;11;Baix Llobregat;08217;Sant Joan Despí;1;;12381;3189;6349;7713;4668;89;52;7572;7624
8;Barcelona;1;Barcelona;11;Baix Llobregat;08217;Sant Joan Despí;2;;3344;693;1427;1659;1685;28;15;1616;1631
8;Barcelona;1;Barcelona;11;Baix Llobregat;08217;Sant Joan Despí;3;;4682;1230;2157;2384;2298;42;12;2330;2342
8;Barcelona;1;Barcelona;11;Baix Llobregat;08217;Sant Joan Despí;4;;2124;443;1192;1422;702;22;15;1385;1400
8;Barcelona;1;Barcelona;11;Baix Llobregat;08217;Sant Joan Despí;5;;2911;625;1592;1892;1019;18;14;1860;1874
8;Barcelona;2;Catalunya Central;7;Bages;08218;Sant Joan de Vilatorrada;1;;8032;2058;3728;4206;3826;38;42;4126;4168
17;Girona;3;Girona;19;Garrotxa;17185;Sant Joan les Fonts;1;;2280;553;1053;1221;1059;9;13;1199;1212
17;Girona;3;Girona;20;Gironès;17166;Sant Jordi Desvalls;1;;547;227;368;413;134;10;0;403;403
8;Barcelona;2;Catalunya Central;14;Berguedà;08903;Sant Julià de Cerdanyola;1;;205;89;150;174;31;0;0;174;174
17;Girona;3;Girona;34;Selva;17903;Sant Julià del Llor i Bonmatí;1;;918;268;508;550;368;6;5;539;544
17;Girona;3;Girona;20;Gironès;17169;Sant Julià de Ramis;1;;2536;730;1423;1623;913;30;18;1575;1593
8;Barcelona;2;Catalunya Central;24;Osona;08220;Sant Julià de Vilatorta;1;;2424;854;1634;1824;600;17;28;1779;1807
8;Barcelona;1;Barcelona;11;Baix Llobregat;08221;Sant Just Desvern;1;;13386;3731;7446;8850;4536;92;55;8703;8758
8;Barcelona;8;Penedès;3;Alt Penedès;08222;Sant Llorenç d'Hortons;1;;1855;502;1059;1225;630;18;16;1191;1207
17;Girona;3;Girona;2;Alt Empordà;17171;Sant Llorenç de la Muga;1;;182;58;115;130;52;3;2;125;127
25;Lleida;2;Catalunya Central;35;Solsonès;25193;Sant Llorenç de Morunys;1;;794;252;429;487;307;12;1;474;475
8;Barcelona;1;Barcelona;40;Vallès Occidental;08223;Sant Llorenç Savall;1;;1957;478;952;1080;877;15;10;1055;1065
8;Barcelona;2;Catalunya Central;24;Osona;08225;Sant Martí d'Albars;1;;97;44;60;69;28;0;1;68;69
8;Barcelona;2;Catalunya Central;24;Osona;08224;Sant Martí de Centelles;1;;884;228;448;524;360;11;4;509;513
17;Girona;3;Girona;20;Gironès;17172;Sant Martí de Llémena;1;;477;162;272;298;179;13;4;281;285
25;Lleida;4;Lleida;38;Urgell;25902;Sant Martí de Riucorb;1;;534;188;289;327;207;10;0;317;317
8;Barcelona;8;Penedès;6;Anoia;08226;Sant Martí de Tous;1;;928;300;608;695;233;15;9;671;680
8;Barcelona;8;Penedès;3;Alt Penedès;08227;Sant Martí Sarroca;1;;2424;631;1151;1376;1048;24;18;1334;1352
8;Barcelona;2;Catalunya Central;6;Anoia;08228;Sant Martí Sesgueioles;1;;287;94;176;200;87;8;3;189;192
17;Girona;3;Girona;20;Gironès;17173;Sant Martí Vell;1;;188;62;119;133;55;0;2;131;133
8;Barcelona;2;Catalunya Central;7;Bages;08229;Sant Mateu de Bages;1;;513;179;328;372;141;6;1;365;366
17;Girona;3;Girona;28;Pla de l'Estany;17174;Sant Miquel de Campmajor;1;;170;54;91;109;61;1;3;105;108
17;Girona;3;Girona;2;Alt Empordà;17175;Sant Miquel de Fluvià;1;;554;163;240;266;288;6;5;255;260
17;Girona;3;Girona;2;Alt Empordà;17176;Sant Mori;1;;118;53;79;92;26;0;1;91;92
17;Girona;3;Girona;31;Ripollès;17177;Sant Pau de Segúries;1;;584;187;296;339;245;16;5;318;323
8;Barcelona;2;Catalunya Central;7;Bages;08192;Santpedor;1;;5715;1426;2925;3502;2213;39;26;3437;3463
8;Barcelona;8;Penedès;17;Garraf;08231;Sant Pere de Ribes;1;;21551;4480;9253;10597;10954;130;85;10382;10467
8;Barcelona;8;Penedès;3;Alt Penedès;08232;Sant Pere de Riudebitlles;1;;1798;484;943;1041;757;17;7;1017;1024
8;Barcelona;2;Catalunya Central;24;Osona;08233;Sant Pere de Torelló;1;;1876;464;956;1110;766;11;15;1084;1099
8;Barcelona;1;Barcelona;41;Vallès Oriental;08234;Sant Pere de Vilamajor;1;;3513;687;1542;1947;1566;103;24;1820;1844
17;Girona;3;Girona;2;Alt Empordà;17178;Sant Pere Pescador;1;;1073;311;542;604;469;7;1;596;597
8;Barcelona;2;Catalunya Central;6;Anoia;08189;Sant Pere Sallavinera;1;;123;47;88;104;19;3;2;99;101
8;Barcelona;1;Barcelona;21;Maresme;08235;Sant Pol de Mar;1;;3976;1142;2145;2602;1374;30;15;2557;2572
8;Barcelona;8;Penedès;3;Alt Penedès;08236;Sant Quintí de Mediona;1;;1609;437;695;892;717;18;10;864;874
8;Barcelona;2;Catalunya Central;24;Osona;08237;Sant Quirze de Besora;1;;1633;521;912;1039;594;18;9;1012;1021
8;Barcelona;1;Barcelona;40;Vallès Occidental;08238;Sant Quirze del Vallès;1;;14968;3717;8256;9571;5397;108;71;9392;9463
8;Barcelona;2;Catalunya Central;42;Moianès;08239;Sant Quirze Safaja;1;;476;119;267;312;164;3;3;306;309
25;Lleida;4;Lleida;32;Segarra;25194;Sant Ramon;1;;403;119;202;244;159;9;2;233;235
8;Barcelona;8;Penedès;3;Alt Penedès;08240;Sant Sadurní d'Anoia;1;;4107;969;2024;2319;1788;41;13;2265;2278
8;Barcelona;8;Penedès;3;Alt Penedès;08240;Sant Sadurní d'Anoia;2;;5374;1277;2696;3199;2175;34;18;3147;3165
8;Barcelona;2;Catalunya Central;24;Osona;08241;Sant Sadurní d'Osormort;1;;66;20;45;51;15;0;0;51;51
8;Barcelona;2;Catalunya Central;7;Bages;08098;Sant Salvador de Guardiola;1;;2495;645;1242;1407;1088;24;17;1366;1383
8;Barcelona;2;Catalunya Central;7;Bages;08262;Sant Vicenç de Castellet;1;;4113;859;1657;1963;2150;42;35;1886;1921
8;Barcelona;2;Catalunya Central;7;Bages;08262;Sant Vicenç de Castellet;2;;2855;653;1177;1360;1495;17;14;1329;1343
8;Barcelona;1;Barcelona;11;Baix Llobregat;08263;Sant Vicenç dels Horts;1;;11711;2594;5305;6098;5613;96;36;5966;6002
8;Barcelona;1;Barcelona;11;Baix Llobregat;08263;Sant Vicenç dels Horts;2;;3021;432;1052;1196;1825;18;16;1162;1178
8;Barcelona;1;Barcelona;11;Baix Llobregat;08263;Sant Vicenç dels Horts;3;;2770;587;1070;1179;1591;16;14;1149;1163
8;Barcelona;1;Barcelona;11;Baix Llobregat;08263;Sant Vicenç dels Horts;4;;3739;899;1721;1956;1783;40;11;1905;1916
8;Barcelona;1;Barcelona;21;Maresme;08264;Sant Vicenç de Montalt;1;;4693;1038;2310;2824;1869;35;22;2767;2789
8;Barcelona;2;Catalunya Central;24;Osona;08265;Sant Vicenç de Torelló;1;;1621;555;1017;1132;489;16;15;1101;1116
43;Tarragona;6;Camp de Tarragona;16;Conca de Barberà;43142;Sarral;1;;1077;254;512;599;478;11;5;583;588
17;Girona;3;Girona;20;Gironès;17186;Sarrià de Ter;1;;3868;1027;1931;2212;1656;35;20;2157;2177
25;Lleida;5;Alt Pirineu i territori d'Aran;25;Pallars Jussà;25201;Sarroca de Bellera;1;;106;17;34;63;43;2;0;61;61
25;Lleida;4;Lleida;33;Segrià;25200;Sarroca de Lleida;1;;311;116;179;197;114;2;1;194;195
17;Girona;3;Girona;2;Alt Empordà;17187;Saus, Camallera i Llampaies;1;;649;226;410;464;185;8;3;453;456
43;Tarragona;6;Camp de Tarragona;16;Conca de Barberà;43143;Savallà del Comtat;1;;51;21;31;36;15;0;1;35;36
43;Tarragona;6;Camp de Tarragona;36;Tarragonès;43144;Secuita, la;1;;1248;330;657;742;506;12;4;726;730
43;Tarragona;6;Camp de Tarragona;8;Baix Camp;43145;Selva del Camp, la;1;;1946;410;912;1125;821;21;8;1096;1104
43;Tarragona;6;Camp de Tarragona;8;Baix Camp;43145;Selva del Camp, la;2;;2334;639;1248;1453;881;34;6;1413;1419
17;Girona;3;Girona;2;Alt Empordà;17188;Selva de Mar, la;1;;171;71;112;128;43;3;1;124;125
43;Tarragona;6;Camp de Tarragona;16;Conca de Barberà;43146;Senan;1;;37;11;19;30;7;1;0;29;29
43;Tarragona;7;Terres de l'Ebre;22;Montsià;43044;Sénia, la;1;;1491;337;623;797;694;14;8;775;783
43;Tarragona;7;Terres de l'Ebre;22;Montsià;43044;Sénia, la;2;;2433;541;952;1204;1229;42;15;1147;1162
25;Lleida;5;Alt Pirineu i territori d'Aran;25;Pallars Jussà;25202;Senterada;1;;104;30;46;57;47;0;0;57;57
25;Lleida;4;Lleida;23;Noguera;25035;Sentiu de Sió, la;1;;367;129;203;237;130;4;3;230;233
8;Barcelona;1;Barcelona;40;Vallès Occidental;08267;Sentmenat;1;;6897;1570;3050;3609;3288;55;33;3521;3554
17;Girona;3;Girona;28;Pla de l'Estany;17190;Serinyà;1;;847;259;486;520;327;15;4;501;505
25;Lleida;4;Lleida;33;Segrià;25204;Seròs;1;;1144;281;582;650;494;10;5;635;640
17;Girona;3;Girona;10;Baix Empordà;17191;Serra de Daró;1;;171;88;134;146;25;0;1;145;146
17;Girona;3;Girona;31;Ripollès;17192;Setcases;1;;147;49;84;96;51;4;4;88;92
25;Lleida;5;Alt Pirineu i territori d'Aran;4;Alt Urgell;25203;Seu d'Urgell, la;1;;8840;1944;3769;4423;4417;86;64;4273;4337
8;Barcelona;2;Catalunya Central;24;Osona;08269;Seva;1;;2780;768;1501;1748;1032;20;28;1700;1728
25;Lleida;4;Lleida;27;Pla d'Urgell;25205;Sidamon;1;;571;208;327;356;215;14;3;339;342
17;Girona;3;Girona;34;Selva;17193;Sils;1;;4405;1150;1947;2161;2244;34;19;2108;2127
8;Barcelona;8;Penedès;17;Garraf;08270;Sitges;1;;6908;1408;3176;3870;3038;36;31;3803;3834
8;Barcelona;8;Penedès;17;Garraf;08270;Sitges;2;;12330;2878;5981;6890;5440;73;52;6765;6817
17;Girona;3;Girona;2;Alt Empordà;17052;Siurana;1;;136;46;85;97;39;1;0;96;96
8;Barcelona;2;Catalunya Central;24;Osona;08271;Sobremunt;1;;65;16;30;36;29;0;2;34;36
25;Lleida;4;Lleida;18;Garrigues;25206;Soleràs, el;1;;254;83;150;185;69;1;3;181;184
43;Tarragona;6;Camp de Tarragona;16;Conca de Barberà;43147;Solivella;1;;529;201;336;375;154;11;7;357;364
25;Lleida;2;Catalunya Central;35;Solsonès;25207;Solsona;1;;4003;876;1784;2145;1858;40;19;2086;2105
25;Lleida;2;Catalunya Central;35;Solsonès;25207;Solsona;2;;2455;553;1117;1342;1113;27;12;1303;1315
8;Barcelona;2;Catalunya Central;24;Osona;08272;Sora;1;;162;46;99;116;46;1;2;113;115
25;Lleida;5;Alt Pirineu i territori d'Aran;26;Pallars Sobirà;25208;Soriguera;1;;342;70;146;217;125;3;1;213;214
25;Lleida;5;Alt Pirineu i territori d'Aran;26;Pallars Sobirà;25209;Sort;1;;1614;300;667;962;652;25;15;922;937
25;Lleida;4;Lleida;33;Segrià;25210;Soses;1;;1063;389;605;673;390;18;4;651;655
8;Barcelona;8;Penedès;3;Alt Penedès;08273;Subirats;1;;2423;793;1465;1649;774;22;10;1617;1627
25;Lleida;4;Lleida;33;Segrià;25211;Sudanell;1;;652;158;317;379;273;5;3;371;374
25;Lleida;4;Lleida;33;Segrià;25212;Sunyer;1;;221;65;124;140;81;1;8;131;139
8;Barcelona;2;Catalunya Central;7;Bages;08274;Súria;1;;4598;1182;2182;2601;1997;38;10;2553;2563
17;Girona;3;Girona;34;Selva;17194;Susqueda;1;;73;32;39;49;24;0;3;46;49
8;Barcelona;1;Barcelona;41;Vallès Oriental;08276;Tagamanent;1;;241;93;130;147;94;0;1;146;147
8;Barcelona;2;Catalunya Central;7;Bages;08277;Talamanca;1;;174;71;113;122;52;1;1;120;121
25;Lleida;5;Alt Pirineu i territori d'Aran;25;Pallars Jussà;25215;Talarn;1;;420;120;168;204;216;4;4;196;200
25;Lleida;4;Lleida;32;Segarra;25216;Talavera;1;;241;80;132;165;76;1;1;163;164
17;Girona;3;Girona;10;Baix Empordà;17195;Tallada d'Empordà, la;1;;351;165;252;278;73;4;2;272;274
8;Barcelona;2;Catalunya Central;24;Osona;08278;Taradell;1;;4999;1487;2726;3229;1770;30;22;3177;3199
43;Tarragona;6;Camp de Tarragona;36;Tarragonès;43148;Tarragona;1;;974;218;386;493;481;14;4;475;479
43;Tarragona;6;Camp de Tarragona;36;Tarragonès;43148;Tarragona;2;;789;183;369;395;394;4;3;388;391
43;Tarragona;6;Camp de Tarragona;36;Tarragonès;43148;Tarragona;3;;3752;1097;2178;2515;1237;18;17;2480;2497
43;Tarragona;6;Camp de Tarragona;36;Tarragonès;43148;Tarragona;4;;12546;2986;6236;7394;5152;95;47;7252;7299
43;Tarragona;6;Camp de Tarragona;36;Tarragonès;43148;Tarragona;5;;7567;1669;3492;4173;3394;70;27;4076;4103
43;Tarragona;6;Camp de Tarragona;36;Tarragonès;43148;Tarragona;6;;16531;3534;7762;9052;7479;118;56;8878;8934
43;Tarragona;6;Camp de Tarragona;36;Tarragonès;43148;Tarragona;7;;29802;6394;13441;16101;13701;239;133;15729;15862
43;Tarragona;6;Camp de Tarragona;36;Tarragonès;43148;Tarragona;8;;13530;2814;4857;5537;7993;94;55;5388;5443
43;Tarragona;6;Camp de Tarragona;36;Tarragonès;43148;Tarragona;9;;5535;1105;1867;2045;3490;22;36;1987;2023
25;Lleida;4;Lleida;38;Urgell;25217;Tàrrega;1;;2639;612;1178;1335;1304;20;25;1290;1315
25;Lleida;4;Lleida;38;Urgell;25217;Tàrrega;2;;3854;1005;1951;2214;1640;47;28;2139;2167
25;Lleida;4;Lleida;38;Urgell;25217;Tàrrega;3;;2912;784;1365;1561;1351;17;18;1526;1544
25;Lleida;4;Lleida;38;Urgell;25217;Tàrrega;4;;1639;424;713;844;795;9;15;820;835
25;Lleida;4;Lleida;18;Garrigues;25218;Tarrés;1;;84;26;51;64;20;0;2;62;64
25;Lleida;4;Lleida;32;Segarra;25219;Tarroja de Segarra;1;;148;26;68;87;61;3;3;81;84
8;Barcelona;2;Catalunya Central;24;Osona;08275;Tavèrnoles;1;;249;89;160;179;70;1;4;174;178
8;Barcelona;2;Catalunya Central;24;Osona;08280;Tavertet;1;;92;36;63;68;24;0;0;68;68
8;Barcelona;1;Barcelona;21;Maresme;08281;Teià;1;;4960;1294;2716;3264;1696;42;21;3201;3222
25;Lleida;4;Lleida;23;Noguera;25220;Térmens;1;;976;410;589;641;335;10;5;626;631
17;Girona;3;Girona;2;Alt Empordà;17196;Terrades;1;;245;83;147;156;89;7;3;146;149
8;Barcelona;1;Barcelona;40;Vallès Occidental;08279;Terrassa;1;;26923;6747;14399;16930;9993;171;185;16574;16759
8;Barcelona;1;Barcelona;40;Vallès Occidental;08279;Terrassa;2;;12936;2098;4392;4965;7971;70;30;4865;4895
8;Barcelona;1;Barcelona;40;Vallès Occidental;08279;Terrassa;3;;17415;3377;7006;8244;9171;118;75;8051;8126
8;Barcelona;1;Barcelona;40;Vallès Occidental;08279;Terrassa;4;;29102;6428;13441;15449;13653;190;162;15097;15259
8;Barcelona;1;Barcelona;40;Vallès Occidental;08279;Terrassa;5;;34592;7701;16018;18389;16203;244;175;17970;18145
8;Barcelona;1;Barcelona;40;Vallès Occidental;08279;Terrassa;6;;28969;5651;10876;12234;16735;158;128;11948;12076
8;Barcelona;1;Barcelona;40;Vallès Occidental;08279;Terrassa;7;;6539;1339;2504;2930;3609;28;29;2873;2902
8;Barcelona;1;Barcelona;21;Maresme;08282;Tiana;1;;6858;1754;3899;4603;2255;45;35;4523;4558
25;Lleida;5;Alt Pirineu i territori d'Aran;26;Pallars Sobirà;25221;Tírvia;1;;118;39;66;85;33;5;1;79;80
25;Lleida;4;Lleida;23;Noguera;25222;Tiurana;1;;67;24;37;53;14;1;0;52;52
43;Tarragona;7;Terres de l'Ebre;9;Baix Ebre;43149;Tivenys;1;;681;234;385;423;258;10;7;406;413
43;Tarragona;7;Terres de l'Ebre;30;Ribera d'Ebre;43150;Tivissa;1;;1219;382;704;834;385;25;6;803;809
8;Barcelona;2;Catalunya Central;24;Osona;08283;Tona;1;;6216;1223;2728;3424;2792;35;44;3345;3389
25;Lleida;4;Lleida;32;Segarra;25223;Torà;1;;905;237;448;541;364;15;6;520;526
8;Barcelona;1;Barcelona;21;Maresme;08284;Tordera;1;;6292;1161;2431;2803;3489;52;20;2731;2751
8;Barcelona;1;Barcelona;21;Maresme;08284;Tordera;2;;6532;1150;2318;2646;3886;51;16;2579;2595
8;Barcelona;2;Catalunya Central;24;Osona;08285;Torelló;1;;3866;916;1746;2048;1818;27;20;2001;2021
8;Barcelona;2;Catalunya Central;24;Osona;08285;Torelló;2;;2354;609;1222;1446;908;28;9;1409;1418
8;Barcelona;2;Catalunya Central;24;Osona;08285;Torelló;3;;4089;1053;1816;2114;1975;44;20;2050;2070
25;Lleida;4;Lleida;18;Garrigues;25224;Torms, els;1;;121;37;73;88;33;1;2;85;87
25;Lleida;4;Lleida;38;Urgell;25225;Tornabous;1;;521;171;284;316;205;1;5;310;315
25;Lleida;4;Lleida;33;Segrià;25226;Torrebesses;1;;239;87;125;143;96;1;0;142;142
25;Lleida;5;Alt Pirineu i territori d'Aran;25;Pallars Jussà;25227;Torre de Cabdella, la;1;;658;142;251;440;218;6;6;428;434
8;Barcelona;8;Penedès;6;Anoia;08286;Torre de Claramunt, la;1;;3000;685;1285;1463;1537;27;15;1421;1436
43;Tarragona;6;Camp de Tarragona;29;Priorat;43151;Torre de Fontaubella, la;1;;106;54;70;83;23;1;1;81;82
43;Tarragona;7;Terres de l'Ebre;30;Ribera d'Ebre;43152;Torre de l'Espanyol, la;1;;427;149;265;293;134;14;1;278;279
43;Tarragona;6;Camp de Tarragona;36;Tarragonès;43153;Torredembarra;1;;11525;2609;4635;5459;6066;98;34;5327;5361
25;Lleida;4;Lleida;33;Segrià;25228;Torrefarrera;1;;3215;695;1477;1766;1449;22;39;1705;1744
25;Lleida;4;Lleida;32;Segarra;25907;Torrefeta i Florejacs;1;;491;144;258;294;197;6;12;276;288
25;Lleida;4;Lleida;27;Pla d'Urgell;25230;Torregrossa;1;;1518;430;784;906;612;19;15;872;887
25;Lleida;4;Lleida;23;Noguera;25231;Torrelameu;1;;483;149;310;358;125;10;2;346;348
8;Barcelona;8;Penedès;3;Alt Penedès;08287;Torrelavit;1;;1075;374;662;730;345;16;7;707;714
8;Barcelona;8;Penedès;3;Alt Penedès;08288;Torrelles de Foix;1;;1746;393;637;764;982;11;5;748;753
8;Barcelona;1;Barcelona;11;Baix Llobregat;08289;Torrelles de Llobregat;1;;4560;940;2186;2688;1872;30;20;2638;2658
17;Girona;3;Girona;10;Baix Empordà;17197;Torrent;1;;126;48;78;91;35;0;3;88;91
25;Lleida;4;Lleida;33;Segrià;25232;Torres de Segre;1;;1340;404;699;782;558;12;4;766;770
25;Lleida;4;Lleida;33;Segrià;25233;Torre-serona;1;;275;91;172;187;88;1;2;184;186
17;Girona;3;Girona;2;Alt Empordà;17198;Torroella de Fluvià;1;;447;151;230;264;183;4;1;259;260
17;Girona;3;Girona;10;Baix Empordà;17199;Torroella de Montgrí;1;;7059;1774;3332;3995;3064;67;30;3898;3928
43;Tarragona;6;Camp de Tarragona;29;Priorat;43154;Torroja del Priorat;1;;121;48;86;99;22;1;1;97;98
17;Girona;3;Girona;19;Garrotxa;17200;Tortellà;1;;635;198;362;416;219;7;6;403;409
43;Tarragona;7;Terres de l'Ebre;9;Baix Ebre;43155;Tortosa;1;;6646;1624;2859;3376;3270;72;38;3266;3304
43;Tarragona;7;Terres de l'Ebre;9;Baix Ebre;43155;Tortosa;2;;4205;1030;1876;2209;1996;46;27;2136;2163
43;Tarragona;7;Terres de l'Ebre;9;Baix Ebre;43155;Tortosa;3;;3484;882;1461;1670;1814;50;14;1606;1620
43;Tarragona;7;Terres de l'Ebre;9;Baix Ebre;43155;Tortosa;4;;8243;1901;3200;3786;4457;62;31;3693;3724
17;Girona;3;Girona;31;Ripollès;17201;Toses;1;;146;35;63;98;48;1;2;95;97
17;Girona;3;Girona;34;Selva;17202;Tossa de Mar;1;;3923;872;1721;2079;1844;48;17;2014;2031
25;Lleida;5;Alt Pirineu i territori d'Aran;25;Pallars Jussà;25234;Tremp;1;;1405;312;555;753;652;23;7;723;730
25;Lleida;5;Alt Pirineu i territori d'Aran;25;Pallars Jussà;25234;Tremp;2;;2327;502;940;1295;1032;22;20;1253;1273
25;Lleida;5;Alt Pirineu i territori d'Aran;25;Pallars Jussà;25234;Tremp;3;;455;73;136;208;247;5;1;202;203
17;Girona;3;Girona;10;Baix Empordà;17204;Ullà;1;;624;200;331;370;254;6;4;360;364
8;Barcelona;1;Barcelona;40;Vallès Occidental;08290;Ullastrell;1;;1567;417;878;991;576;10;6;975;981
17;Girona;3;Girona;10;Baix Empordà;17205;Ullastret;1;;194;76;121;142;52;1;0;141;141
43;Tarragona;7;Terres de l'Ebre;22;Montsià;43156;Ulldecona;1;;2901;615;1054;1521;1380;28;18;1475;1493
43;Tarragona;7;Terres de l'Ebre;22;Montsià;43156;Ulldecona;2;;1092;190;333;473;619;8;3;462;465
43;Tarragona;6;Camp de Tarragona;29;Priorat;43157;Ulldemolins;1;;349;164;241;270;79;4;3;263;266
17;Girona;3;Girona;10;Baix Empordà;17203;Ultramort;1;;162;60;94;105;57;2;2;101;103
17;Girona;5;Alt Pirineu i territori d'Aran;15;Cerdanya;17206;Urús;1;;175;43;98;122;53;5;1;116;117
8;Barcelona;1;Barcelona;40;Vallès Occidental;08291;Vacarisses;1;;5240;746;2109;2539;2701;26;20;2493;2513
17;Girona;3;Girona;2;Alt Empordà;17014;Vajol, la;1;;62;20;36;40;22;0;0;40;40
8;Barcelona;8;Penedès;6;Anoia;08292;Vallbona d'Anoia;1;;1062;286;557;648;414;12;5;631;636
25;Lleida;4;Lleida;38;Urgell;25238;Vallbona de les Monges;1;;212;80;122;141;71;7;1;133;134
8;Barcelona;2;Catalunya Central;14;Berguedà;08293;Vallcebre;1;;237;73;128;165;72;3;1;161;162
43;Tarragona;6;Camp de Tarragona;16;Conca de Barberà;43158;Vallclara;1;;74;28;45;56;18;6;0;50;50
17;Girona;3;Girona;19;Garrotxa;17207;Vall d'en Bas, la;1;;2444;801;1479;1668;776;22;32;1614;1646
17;Girona;3;Girona;19;Garrotxa;17208;Vall de Bianya, la;1;;1013;279;510;586;427;9;14;563;577
25;Lleida;5;Alt Pirineu i territori d'Aran;5;Alta Ribagorça;25043;Vall de Boí, la;1;;819;210;352;498;321;15;3;480;483
25;Lleida;5;Alt Pirineu i territori d'Aran;26;Pallars Sobirà;25901;Vall de Cardós;1;;303;63;143;213;90;9;0;204;204
25;Lleida;4;Lleida;23;Noguera;25240;Vallfogona de Balaguer;1;;1361;439;763;850;511;16;12;822;834
17;Girona;3;Girona;31;Ripollès;17170;Vallfogona de Ripollès;1;;179;73;113;133;46;0;0;133;133
43;Tarragona;6;Camp de Tarragona;16;Conca de Barberà;43159;Vallfogona de Riucorb;1;;76;32;47;59;17;2;1;56;57
8;Barcelona;1;Barcelona;41;Vallès Oriental;08294;Vallgorguina;1;;2194;587;1098;1258;936;22;7;1229;1236
8;Barcelona;1;Barcelona;11;Baix Llobregat;08295;Vallirana;1;;11512;2452;4656;5734;5778;73;38;5623;5661
17;Girona;3;Girona;10;Baix Empordà;17209;Vall-llobrega;1;;639;144;386;427;212;7;4;416;420
43;Tarragona;6;Camp de Tarragona;1;Alt Camp;43160;Vallmoll;1;;1331;353;675;759;572;9;14;736;750
8;Barcelona;1;Barcelona;41;Vallès Oriental;08296;Vallromanes;1;;1873;462;991;1244;629;17;6;1221;1227
43;Tarragona;6;Camp de Tarragona;1;Alt Camp;43161;Valls;1;;503;107;204;230;273;0;0;230;230
43;Tarragona;6;Camp de Tarragona;1;Alt Camp;43161;Valls;2;;512;85;157;178;334;7;3;168;171
43;Tarragona;6;Camp de Tarragona;1;Alt Camp;43161;Valls;3;;1249;250;521;582;667;7;9;566;575
43;Tarragona;6;Camp de Tarragona;1;Alt Camp;43161;Valls;4;;3397;699;1431;1664;1733;26;8;1630;1638
43;Tarragona;6;Camp de Tarragona;1;Alt Camp;43161;Valls;5;;3985;964;1701;1915;2070;21;7;1887;1894
43;Tarragona;6;Camp de Tarragona;1;Alt Camp;43161;Valls;6;;7450;1814;3588;4023;3427;56;23;3944;3967
25;Lleida;5;Alt Pirineu i territori d'Aran;4;Alt Urgell;25906;Valls d'Aguilar, les;1;;211;47;87;122;89;1;1;120;121
25;Lleida;5;Alt Pirineu i territori d'Aran;4;Alt Urgell;25239;Valls de Valira, les;1;;579;107;189;238;341;4;0;234;234
43;Tarragona;6;Camp de Tarragona;8;Baix Camp;43162;Vandellòs i l'Hospitalet de l'Infant;1;;4476;1072;1973;2485;1991;33;23;2429;2452
25;Lleida;5;Alt Pirineu i territori d'Aran;4;Alt Urgell;25909;Vansa i Fórnols, la;1;;131;47;66;90;41;4;1;85;86
8;Barcelona;2;Catalunya Central;6;Anoia;08297;Veciana;1;;135;52;76;90;45;2;4;84;88
43;Tarragona;8;Penedès;12;Baix Penedès;43163;Vendrell, el;1;;3227;505;1272;1519;1708;31;10;1478;1488
43;Tarragona;8;Penedès;12;Baix Penedès;43163;Vendrell, el;2;;7475;1240;2429;2824;4651;45;30;2749;2779
43;Tarragona;8;Penedès;12;Baix Penedès;43163;Vendrell, el;3;;15863;3265;6205;7285;8578;145;61;7079;7140
17;Girona;3;Girona;2;Alt Empordà;17210;Ventalló;1;;602;157;338;387;215;9;5;373;378
25;Lleida;4;Lleida;38;Urgell;25242;Verdú;1;;703;176;351;404;299;8;3;393;396
17;Girona;3;Girona;10;Baix Empordà;17211;Verges;1;;846;305;517;595;251;7;5;583;588
43;Tarragona;6;Camp de Tarragona;36;Tarragonès;43164;Vespella de Gaià;1;;319;111;153;180;139;3;0;177;177
8;Barcelona;2;Catalunya Central;24;Osona;08298;Vic;1;;1447;361;738;863;584;12;3;848;851
8;Barcelona;2;Catalunya Central;24;Osona;08298;Vic;2;;7778;2070;4091;4699;3079;57;39;4603;4642
8;Barcelona;2;Catalunya Central;24;Osona;08298;Vic;3;;11979;3095;5844;6730;5249;76;57;6597;6654
8;Barcelona;2;Catalunya Central;24;Osona;08298;Vic;4;;5412;1202;2551;2934;2478;51;27;2856;2883
8;Barcelona;2;Catalunya Central;24;Osona;08298;Vic;5;;582;208;388;420;162;3;1;416;417
17;Girona;2;Catalunya Central;24;Osona;17212;Vidrà;1;;148;50;90;113;35;3;6;104;110
17;Girona;3;Girona;34;Selva;17213;Vidreres;1;;5679;1086;2138;2593;3086;40;27;2526;2553
25;Lleida;5;Alt Pirineu i territori d'Aran;39;Consell General d'Aran;25243;Vielha e Mijaran;1;;3754;618;1259;1721;2033;38;19;1664;1683
43;Tarragona;6;Camp de Tarragona;1;Alt Camp;43165;Vilabella;1;;557;197;364;399;158;6;4;389;393
17;Girona;3;Girona;2;Alt Empordà;17214;Vilabertran;1;;710;200;380;434;276;12;2;420;422
17;Girona;3;Girona;20;Gironès;17215;Vilablareix;1;;2426;753;1424;1663;763;33;28;1602;1630
8;Barcelona;2;Catalunya Central;14;Berguedà;08299;Vilada;1;;375;138;219;245;130;2;7;236;243
17;Girona;3;Girona;2;Alt Empordà;17217;Viladamat;1;;365;153;249;277;88;3;3;271;274
17;Girona;3;Girona;20;Gironès;17216;Viladasens;1;;163;51;106;118;45;5;0;113;113
8;Barcelona;1;Barcelona;11;Baix Llobregat;08301;Viladecans;1;;18105;4222;7965;9216;8889;159;77;8980;9057
8;Barcelona;1;Barcelona;11;Baix Llobregat;08301;Viladecans;2;;31199;6730;13452;15088;16111;248;140;14700;14840
8;Barcelona;1;Barcelona;40;Vallès Occidental;08300;Viladecavalls;1;;5991;1470;3189;3560;2431;61;36;3463;3499
17;Girona;3;Girona;28;Pla de l'Estany;17218;Vilademuls;1;;578;205;369;423;155;9;7;407;414
17;Girona;2;Catalunya Central;24;Osona;17220;Viladrau;1;;832;280;542;592;240;14;4;574;578
17;Girona;3;Girona;2;Alt Empordà;17221;Vilafant;1;;4188;1108;2078;2393;1795;39;18;2336;2354
8;Barcelona;8;Penedès;3;Alt Penedès;08305;Vilafranca del Penedès;1;;3633;1018;1786;1982;1651;25;9;1948;1957
8;Barcelona;8;Penedès;3;Alt Penedès;08305;Vilafranca del Penedès;2;;7934;1999;3560;4007;3927;62;28;3917;3945
8;Barcelona;8;Penedès;3;Alt Penedès;08305;Vilafranca del Penedès;3;;5120;1197;2503;2925;2195;42;28;2855;2883
8;Barcelona;8;Penedès;3;Alt Penedès;08305;Vilafranca del Penedès;4;;11009;2985;5709;6634;4375;90;50;6494;6544
25;Lleida;4;Lleida;38;Urgell;25244;Vilagrassa;1;;385;124;241;252;133;10;5;237;242
17;Girona;3;Girona;2;Alt Empordà;17223;Vilajuïga;1;;819;193;407;477;342;3;7;467;474
43;Tarragona;7;Terres de l'Ebre;37;Terra Alta;43175;Vilalba dels Arcs;1;;531;149;265;318;213;4;5;309;314
8;Barcelona;1;Barcelona;41;Vallès Oriental;08306;Vilalba Sasserra;1;;544;150;260;292;252;8;2;282;284
25;Lleida;5;Alt Pirineu i territori d'Aran;5;Alta Ribagorça;25245;Vilaller;1;;433;128;201;245;188;2;5;238;243
43;Tarragona;6;Camp de Tarragona;36;Tarragonès;43166;Vilallonga del Camp;1;;1628;392;769;850;778;14;9;827;836
17;Girona;3;Girona;31;Ripollès;17224;Vilallonga de Ter;1;;292;97;154;176;116;25;1;150;151
17;Girona;3;Girona;2;Alt Empordà;17225;Vilamacolum;1;;207;75;126;136;71;0;4;132;136
17;Girona;3;Girona;2;Alt Empordà;17226;Vilamalla;1;;878;260;412;456;422;3;8;445;453
17;Girona;3;Girona;2;Alt Empordà;17227;Vilamaniscle;1;;148;51;81;95;53;0;0;95;95
25;Lleida;5;Alt Pirineu i territori d'Aran;39;Consell General d'Aran;25247;Vilamòs;1;;147;30;45;72;75;1;3;68;71
17;Girona;3;Girona;2;Alt Empordà;17228;Vilanant;1;;287;99;176;191;96;5;1;185;186
43;Tarragona;6;Camp de Tarragona;8;Baix Camp;43167;Vilanova d'Escornalbou;1;;417;137;253;282;135;5;6;271;277
25;Lleida;4;Lleida;27;Pla d'Urgell;25248;Vilanova de Bellpuig;1;;874;284;537;625;249;9;15;601;616
25;Lleida;4;Lleida;23;Noguera;25249;Vilanova de l'Aguda;1;;172;54;93;106;66;6;0;100;100
25;Lleida;4;Lleida;33;Segrià;25254;Vilanova de la Barca;1;;709;196;357;419;290;13;3;403;406
8;Barcelona;8;Penedès;6;Anoia;08302;Vilanova del Camí;1;;9419;1996;3810;4307;5112;102;45;4160;4205
8;Barcelona;1;Barcelona;41;Vallès Oriental;08902;Vilanova del Vallès;1;;4043;969;1947;2278;1765;40;26;2212;2238
25;Lleida;4;Lleida;23;Noguera;25250;Vilanova de Meià;1;;324;105;171;209;115;6;2;201;203
43;Tarragona;6;Camp de Tarragona;16;Conca de Barberà;43168;Vilanova de Prades;1;;82;27;41;53;29;3;1;49;50
8;Barcelona;2;Catalunya Central;24;Osona;08303;Vilanova de Sau;1;;263;107;158;191;72;2;0;189;189
25;Lleida;4;Lleida;33;Segrià;25251;Vilanova de Segrià;1;;714;195;394;437;277;3;14;420;434
8;Barcelona;8;Penedès;17;Garraf;08307;Vilanova i la Geltrú;1;;13785;3673;6659;7674;6111;101;65;7508;7573
8;Barcelona;8;Penedès;17;Garraf;08307;Vilanova i la Geltrú;2;;10726;2428;5055;5826;4900;66;40;5720;5760
8;Barcelona;8;Penedès;17;Garraf;08307;Vilanova i la Geltrú;3;;5477;1089;2388;2726;2751;43;30;2653;2683
8;Barcelona;8;Penedès;17;Garraf;08307;Vilanova i la Geltrú;4;;19570;4625;8837;10089;9481;154;87;9848;9935
43;Tarragona;6;Camp de Tarragona;8;Baix Camp;43169;Vilaplana;1;;434;169;309;355;79;1;3;351;354
43;Tarragona;6;Camp de Tarragona;1;Alt Camp;43170;Vila-rodona;1;;899;250;512;574;325;14;7;553;560
17;Girona;3;Girona;2;Alt Empordà;17230;Vila-sacra;1;;501;155;271;300;201;3;3;294;297
25;Lleida;4;Lleida;27;Pla d'Urgell;25252;Vila-sana;1;;570;173;269;304;266;1;10;293;303
43;Tarragona;6;Camp de Tarragona;36;Tarragonès;43171;Vila-seca;1;;15025;3464;6553;7436;7589;132;65;7239;7304
8;Barcelona;1;Barcelona;21;Maresme;08214;Vilassar de Dalt;1;;4192;1058;1894;2460;1732;28;26;2406;2432
8;Barcelona;1;Barcelona;21;Maresme;08214;Vilassar de Dalt;2;;2857;844;1521;1800;1057;18;17;1765;1782
8;Barcelona;1;Barcelona;21;Maresme;08219;Vilassar de Mar;1;;7543;2019;4043;4823;2720;60;32;4731;4763
8;Barcelona;1;Barcelona;21;Maresme;08219;Vilassar de Mar;2;;4841;1280;2672;3167;1674;45;24;3098;3122
8;Barcelona;1;Barcelona;21;Maresme;08219;Vilassar de Mar;3;;3419;804;1533;1813;1606;16;14;1783;1797
17;Girona;3;Girona;2;Alt Empordà;17222;Vilaür;1;;108;57;81;92;16;4;2;86;88
43;Tarragona;6;Camp de Tarragona;16;Conca de Barberà;43172;Vilaverd;1;;341;88;149;177;164;8;6;163;169
43;Tarragona;6;Camp de Tarragona;29;Priorat;43173;Vilella Alta, la;1;;97;38;64;69;28;1;2;66;68
43;Tarragona;6;Camp de Tarragona;29;Priorat;43174;Vilella Baixa, la;1;;147;48;95;118;29;1;0;117;117
17;Girona;3;Girona;34;Selva;17233;Vilobí d'Onyar;1;;2386;682;1335;1479;907;25;11;1443;1454
8;Barcelona;8;Penedès;3;Alt Penedès;08304;Vilobí del Penedès;1;;842;180;455;541;301;5;2;534;536
17;Girona;3;Girona;10;Baix Empordà;17232;Vilopriu;1;;171;78;105;119;52;1;1;117;118
25;Lleida;4;Lleida;18;Garrigues;25253;Vilosell, el;1;;154;44;101;118;36;2;2;114;116
43;Tarragona;6;Camp de Tarragona;16;Conca de Barberà;43176;Vimbodí i Poblet;1;;735;249;397;472;263;12;2;458;460
25;Lleida;4;Lleida;18;Garrigues;25255;Vinaixa;1;;383;134;235;265;118;7;2;256;258
43;Tarragona;7;Terres de l'Ebre;30;Ribera d'Ebre;43177;Vinebre;1;;287;126;200;219;68;4;1;214;215
43;Tarragona;6;Camp de Tarragona;8;Baix Camp;43178;Vinyols i els Arcs;1;;1495;439;781;883;612;10;9;864;873
8;Barcelona;2;Catalunya Central;14;Berguedà;08308;Viver i Serrateix;1;;139;49;83;104;35;1;3;100;103
43;Tarragona;7;Terres de l'Ebre;9;Baix Ebre;43052;Xerta;1;;917;267;436;521;396;18;2;501;503
8;Barcelona;98;Residents Absents;;;08998;Residents Absents;1;;197011; ; ;7996;189015;460;41;7495;7536
17;Girona;98;Residents Absents;;;17998;Residents Absents;1;;21379; ; ;1029;20350;2;3;1024;1027
25;Lleida;98;Residents Absents;;;25998;Residents Absents;1;;17363; ; ;725;16638;9;3;713;716
43;Tarragona;98;Residents Absents;;;43998;Residents Absents;1;;19411; ; ;966;18445;7;8;951;959
